Na wszelki wypadek [MASK] twardo dzierżą mężczyźni .	władze
– Chyba zaraz [MASK] zastrzelę !	cię
Dlatego nigdy się [MASK] nie kąpie , bo mogą się przeziębić i zginąć .	ich
- Wysoki Senat [MASK] szesnastą odrzucił .	poprawkę
Wychowani na prymitywnych filmikach amerykańskich Polacy [MASK] uważają za siłę .	chamstwo
Do tak drastycznej decyzji [MASK] holdingu zmusiła sytuacja ekonomiczna .	szefostwo
O ile jednak społeczeństwa raczej nie można wymienić , o tyle [MASK] - a ściśle , jej kierownictwo - owszem .	telewizję
" Neues Deutschland " [MASK] o przekazaniu daru zatytułowało cytatem z " Ody do radości " kończącej IX Symfonię : " Wszyscy ludzie będą braćmi " .	artykuł
Na ich temat [MASK] również nie powiedzieli płatni informatorzy , do których w tej sprawie zwrócili się policjanci prowadzący dochodzenie .	nic
Jak wielu moich rówieśników inaczej swoje [MASK] planował , a inaczej się potoczyło .	życie
5 . W przypadku gdy okres ważności nie zostanie przedłużony , [MASK] typu uznaje się za ważne w odniesieniu do przyrządów pomiarowych wprowadzonych już do użytkowania .	zatwierdzenie
A ponieważ do tego - z powodu małej wprawy - nie zawsze potrafi właściwie ocenić wszystkie czynniki , które narzucają zmniejszenie prędkości - tym bardziej [MASK] ograniczyć .	ją
A tak już nigdy [MASK] nie zobaczę .	jej
- Zamiast zbierać grosz do grosza , [MASK] tracisz .	wszystko
Ile i komu zaległych [MASK] podatkowych naprawdę umorzył wójt gminy Śliwice Jerzy Bogusławski ?	należności
Zgodnie z MSR 8 [MASK] zmiany oszacowań ujmuje się w bieżącym i kolejnych okresach .	wpływ
Głośna muzyka i bycie niemiłym [MASK] nie rozwiąże .	niczego
Boże , jak ja [MASK] kochał em .	ją
Uzyskane w ten sposób [MASK] zbiorcze uważa się za reprezentatywne dla partii , z których pochodzą .	próbki
W skonsolidowanym rachunku zysków i strat [MASK] i koszty jednostek objętych konsolidacją uwzględnia się w całości .	przychody
A nowe , dwupokojowe [MASK] otrzymali państwo Sknerowie .	mieszkanko
- Czy pani to [MASK] nie mówi ?	nic
Gdyby naprawdę spieszył się do pracy , pewnie by [MASK] zirytowała .	go
Ha , już [MASK] widzę !	go
I jak pan sobie tę [MASK] tłumaczy ?	metaforkę
Jeżeli był to napalm lub jego pochodna , moje [MASK] przeżarł by w okamgnieniu .	tenisówki
Kto teraz ów [MASK] wyprowadzi ?	sztandar
Mimo jej wścibstwa Elizabeth [MASK] lubiła .	ją
– Niech już tylko pan [MASK] nie opowiada .	nic
no przecież Krzak Krzaklewski [MASK] teraz zrobił . .	co
Obu nóg katapulta drakleńska [MASK] pozbawiła !	mnie
Od kogo ja teraz [MASK] pożyczę ?	coś
Odręcznie napisany po arabsku [MASK] zaprezentowała katarska telewizja Al-Dżazira .	list
Pan porucznik Barański [MASK] szuka .	pana
Przez siedem lat [MASK] już sprywatyzowano .	wiele
Prędzej czy później [MASK] szlag trafi .	Unię
Również czasami sąsiadka [MASK] mi wyniesie na klatkę .	coś
Ten barwny świat już [MASK] porwał , a ja , dobry tatuś z bajeczki , stał em się tylko przeszkodą .	ją
W 53 . min dwójkową [MASK] przeprowadzili Krupa i Zięba .	akcję
W pięciu sklepach [MASK] nie znaleziono , przeszukiwania pozostałych trwają .	nic
6 lat temu jej [MASK] zamordowano .	dziecko
- A czemu śmy [MASK] nie ochrzcili ?	ich
- A gdzie wy [MASK] trzymacie ?	garnki
– a ja [MASK] w życiu nie odchudzała m . .	się
- A latem jak [MASK] kochasz ?	mnie
A może ktoś im taką [MASK] dał w prezencie ?	licencję
A może mi [MASK] tylko opowiadali .	to
A może nikt [MASK] nie zauważył ?	tego
- A po co [MASK] malował eś ?	to
A ty , Adam , [MASK] nie kombinuj .	nic
- Ale jak [MASK] osiągnąć na szerszą skalę ?	to
- Ale nie ty [MASK] będziesz zatrzymywał .	go
– ale oni ci [MASK] mówią ?	to
Ale ten argument [MASK] nie przekonuje .	opozycji
Ale to już [MASK] nie zmieni .	niczego
Aresztowanego na 48 godzin [MASK] zwolniono po poręczeniu majątkowym .	mistrza
- Bo mu tu Raszewski taki [MASK] plecie .	wieniec
Bo niby premier [MASK] mówi , ale przecież wiadomo , że on jest w coś uwikłany .	coś
Bo ta kobieta na pewno [MASK] przed nim ukryła .	to
- Bo ście moje [MASK] w sąsieku zamknęli .	kury
– będę jej [MASK] przenosiła na drugi koniec pokoju .	plażę
Choć dziecko złożyło na policji zeznania , [MASK] nie zatrzymano .	sprawców
Czy naprawdę był by m jej [MASK] zrobił za Zucha ?	coś
— Czym pani [MASK] tłumaczy ?	to
Decyzje personalne , [MASK] trudno odwrócić .	które
- Dzieci , [MASK] mówicie .	co
Gdyby mógł wtedy dopaść Szamila , niechybnie by [MASK] zabił .	go
- Gdyby m jeszcze raz miał objąć funkcję prezesa , na pewno wiele [MASK] zrobił by m inaczej .	rzeczy
gdzieś tam ktoś [MASK] powiedział . .	coś
- I ja [MASK] kocham .	go
– i on sobie sam [MASK] wypisał .	wszystko
I Pan Jezus [MASK] nad nimi uczynił , a oni się zamienili w trzy drzewa jabłonne .	krzyż
I podobno wcale [MASK] nie dogonili .	ich
– i takie [MASK] kupują zawodowi akordeoniści ?	akordeony
Ja by m [MASK] prowadził ? !	komunę
Ja by m to [MASK] uogólnił .	pytanie
– ja sobie [MASK] wyobraziła m inaczej .	to
Jak długo jeszcze trupy z esbeckich szaf będą [MASK] straszyć ?	nas
– jak my [MASK] odpakujemy ?	to
- Jak pan [MASK] zrobił ?	to
- Jak się tę cenną [MASK] zdobywało ?	rzecz
– jeszcze dziesięć [MASK] wyjeżdżę i zdaję . .	godzin
- Jezu , [MASK] to naprawdę dręczy .	ciebie
- Jeśli nie będziesz [MASK] zdradzać .	mnie
Jeśli resort zaakceptuje programy , będzie [MASK] finansować .	je
– Już mi [MASK] pan mówił .	to
Kaczka bez brata [MASK] nie ugryzie w łydkę .	nikogo
Kaczka bez brata [MASK] nie ugryzie w łydkę .	nikogo
Kaczka bez brata [MASK] nie ugryzie w łydkę .	nikogo
Kaśka , co [MASK] ugryzło ?	cię
Każde nowo przyniesione kartonowe [MASK] natychmiast któryś zajmuje .	pudło
– każdy swoją [MASK] jakąś wyciągnie .	połóweczkę
Kto wiatr sieje , ten [MASK] zbiera .	burzę
Leżącego na trawie obok drogi [MASK] zauważyły przejeżdżające tamtędy przypadkowe osoby .	mężczyznę
Może pan jeszcze [MASK] wymieni ?	jakieś
" Może tego [MASK] uderzył em .	pana
- Na jarmarku w Ostrowcu konie [MASK] stratowały .	biedaka
– nie będę [MASK] później znosić .	cię
- Nie będę [MASK] komentował .	tego
Nie do was jednych [MASK] wożę .	towar
Nieboszczyk ojciec zawsze nam [MASK] śpiewał i na pedałowej harmonii sobie podgrywał .	to
- Niech pani [MASK] schowa i nikt nie potrzebuje wiedzieć , że ja to pani dała m .	to
- Niech pani [MASK] skieruje do siebie .	to
Niezależnie od przedstawionych wyników , [MASK] przeprowadzą jeszcze policjanci z Komendy Wojewódzkiej Policji w Katowicach .	kontrolę
Niezwyciężony lęk przed dziwem w każdym momencie [MASK] przychodniów przeszywał .	serca
No dobrze , dobrze , już [MASK] nie mówię .	nic
Oczywiście tę moją [MASK] o każdy szczegół bryczki spostrzegł kowal .	zapobiegliwość
Od lat siedemdziesiątych coraz większą [MASK] zdobywa nurt neuroteologiczny .	popularność
Odkąd walczę ze starą , on głównie [MASK] utrzymuje .	mnie
Omawiana książka jeszcze raz [MASK] potwierdza .	to
Ostatnie odkrycie tylko [MASK] potwierdza .	to
- Pan inżynier [MASK] by nie popił ?	rosołku
– Pani nadal [MASK] kocha ?	go
Pani wójt ten [MASK] wygrała .	plebiscyt
Panie marszałku , jakiego [MASK] pan oczekuje ?	wyniku
– Po co [MASK] tu przysłali ?	go
Po naszym reportażu [MASK] o odwołaniu zarządu zdjęto z porządku obrad .	punkt
Po spotkaniu w magistracie faktycznie [MASK] wynajął za własne pieniądze .	ją
Poza Centralną Komisją Wyborczą [MASK] liczy także LADO .	głosy
Prezes PiS-u piątkowym wystąpieniem tę [MASK] potwierdził .	opinię
Przebiegające pod miastem [MASK] kopalni zalano wodą , a wzgórze zgniło i zapadło się w ziemię jak przydeptane .	chodniki
Przecież Hanka tak [MASK] kocha .	go
- Przecież ludzie będą [MASK] brać do ręki .	to
- Przecież pan [MASK] przyprowadził .	ich
Pszemol , naprawdę [MASK] to nie przekonuje .	Cię
Rządy Leszka Millera [MASK] dały wielu ludziom .	dużo
- Skąd ja [MASK] znam ?	to
- Sura , [MASK] wzięła ś ?	łyżkę
Tak , jak mówił em o tym w Sejmie , niewątpliwie [MASK] budzi jego odwaga .	respekt
Teraz już i [MASK] obserwuje uważnie .	mnie
toż do roku żadnej [MASK] nie przespała m . .	nocy
Ty nigdy więcej takiego [MASK] nie zrobisz .	czegoś
- Tydzień temu koń [MASK] stratował i też tak mówił .	go
- Tylko mu [MASK] nie daję .	lodów
Umyślnie i złośliwie [MASK] oszukały ście !	nas
Uparci i bezkompromisowi , [MASK] przerażali , innych zachwycali .	jednych
W Europie początkowo [MASK] sprzedawali medycy , zalecając ją na smutki i przygnębienie .	kawę
W kościele mariackim w Radomiu o północy [MASK] święto odprawił biskup senior Edward Materski .	mszę
W marzeniach sennych główną [MASK] grają symbole .	rolę
W najbliższych dniach [MASK] nie zasypią śmieci .	Warszawy
W obu przypadkach [MASK] rozpatrzy sąd .	zażalenia
W ostatniej minucie [MASK] kolończyków przypieczętował Marcel Witeczek .	klęskę
W Paryżu , grając na giełdzie , [MASK] podobno podwoił .	majątek
W początkach następnego tysiąclecia jej [MASK] pokrył śmietnik .	ruiny
W samej Warszawie w Internecie swoje [MASK] eksponuje już kilkadziesiąt komisów .	auta
W takich warunkach [MASK] dobrego nie napiszę .	niczego
W tej sytuacji wiele [MASK] w pociągach nad morze , w góry i na Mazury zajmują koloniści .	przedziałów
W tych miastach znaczne [MASK] zdobyła sobie wiara protestancka .	wpływy
W tym roku [MASK] pogłębiła jeszcze zima .	uszkodzenia
W ubiegłym roku w czerwcu [MASK] w komunalnym mieszkaniu Salwockich wybijano trzy razy .	okna
W Unii Europejskiej [MASK] opracowuje się raz na 7 lat .	budżet
Wąż w kieszeni [MASK] uratował .	go
Z drugiej strony pisowcy chyba [MASK] polubili .	mnie
Za co tak [MASK] nie lubią partyjni towarzysze ?	Semaka
Zdaniem Marka Markiewicza , polityczną [MASK] polityk osiąga dopiero po czterdziestce .	dojrzałość
Świat Rydzyka tego [MASK] nie wydumał .	wszystkiego
Kilka kolorowo ubranych [MASK] tańczy z uniesionymi rękami .	osób
Bo niby premier [MASK] mówi , ale przecież wiadomo , że on jest w coś uwikłany .	coś
Omawiana książka jeszcze raz [MASK] potwierdza .	to
W marzeniach sennych główną [MASK] grają symbole .	rolę
Prezes PiS-u piątkowym wystąpieniem tę [MASK] potwierdził .	opinię
W samej Warszawie w Internecie swoje [MASK] eksponuje już kilkadziesiąt komisów .	auta
W ostatniej minucie [MASK] kolończyków przypieczętował Marcel Witeczek .	klęskę
Choć dziecko złożyło na policji zeznania , [MASK] nie zatrzymano .	sprawców
Jeśli resort zaakceptuje programy , będzie [MASK] finansować .	je
I podobno wcale [MASK] nie dogonili .	ich
I Pan Jezus [MASK] nad nimi uczynił , a oni się zamienili w trzy drzewa jabłonne .	krzyż
Oczywiście tę moją [MASK] o każdy szczegół bryczki spostrzegł kowal .	zapobiegliwość
- I ja [MASK] kocham .	go
Czy naprawdę był by m jej [MASK] zrobił za Zucha ?	coś
Przebiegające pod miastem [MASK] kopalni zalano wodą , a wzgórze zgniło i zapadło się w ziemię jak przydeptane .	chodniki
– Po co [MASK] tu przysłali ?	go
— Czym pani [MASK] tłumaczy ?	to
Dla cięższej gramatury gastronomicznej trzykrotnie [MASK] się wyparł em .	polskości
W ubiegłym roku w czerwcu [MASK] w komunalnym mieszkaniu Salwockich wybijano trzy razy .	okna
W najbliższych dniach [MASK] nie zasypią śmieci .	Warszawy
- Tylko mu [MASK] nie daję .	lodów
W tym roku [MASK] pogłębiła jeszcze zima .	uszkodzenia
Jak stwierdzał akt oskarżenia : " [MASK] swe porzucili pielęgniarze i pielęgniarki nawet w tych oddziałach , w których byli ciężko chorzy , furiaci oraz tam , gdzie byli podsądni oddani z mocy decyzji sądowej do szpitala na obserwację " .	Obowiązki
Z tych samych środków , które zasiliły konto Hufca ZHP , [MASK] zdobyło także Stowarzyszenie Na Rzecz Szkolnictwa Specjalnego .	dofinansowanie
John Lennon , legendarny muzyk z zespołu The Beatles , wspierał terrorystów z Irlandzkiej Armii Republikańskiej ( IRA ) oraz trockistów - takie [MASK] ujawniła wczoraj brytyjska prasa .	rewelacje
8 . W przypadku regionalnej placówki opiekuńczo - wychowawczej finansowanej z dochodów własnych samorządu województwa [MASK] o odpłatności wydaje marszałek województwa na podstawie ust . 1 , 2 , 4 i 5 .	decyzję
Po drodze do celu [MASK] niszczysz - ludzi przede wszystkim .	wszystko
Po prawie dwóch godzinach poszukiwań [MASK] dziecka znaleźli miejscowi strażacy .	zwłoki
Bo i ona [MASK] wszystkich właśnie tak usidliła .	nas
Ale skoro przyspieszenie , uzyskiwane dzięki zastosowaniu Serial ATA/150 , jest praktycznie znikome , to jakie [MASK] przynosi nam nowy interfejs ?	korzyści
Pierwsze i drugie [MASK] zajęły słowackie dziewczęta , ubrane w getry i krótkie falbankowe spódniczki .	miejsce
1a . W przedsiębiorstwie użyteczności publicznej , dla którego organem założycielskim jest wojewoda i którego działalność wykracza poza obszar województwa , [MASK] zatwierdza wojewoda w porozumieniu z ministrem właściwym ze względu na przedmiot działalności przedsiębiorstwa .	statut
W drugiej połowie XIX wieku [MASK] walki podjęli robotnicy .	sztandar
12 . 5 . [MASK] rosnące wprost przed moim oknem ( mieszkam przy Bradmore Road w suterenie ) zauważył em dopiero wówczas , kiedy jednemu z nich opadł płatek .	Tulipany
W 8 . min spotkania indywidualną [MASK] przeprowadził Janiak .	akcję
Na zakończenie uroczystości [MASK] zabrał sam ks . kardynał Sodano , który na początku niemal czystą polszczyzną przywitał przybyłych gości oraz wyraził swoje zadowolenie z pobytu we Wrocławiu .	głos
Jak mam porządek w szafie to [MASK] nie znajdę ( dlatego zawsze mam bałagan )	nic
Krążące w " środowisku " [MASK] na temat rychłego utworzenia partii chadeckiej uważam za mało prawdopodobne .	plotki
P.S . Następujący jeszcze dłuższy [MASK] o starej Warszawie pomijam - był by ciekawym uzupełnieniem ewentualnej dyskusji , ale nie może być jej zarzewiem .	komentarz
U nas z kolei [MASK] Chełmińskiego przerabia się na Chełmońskiego ( wystarczy zmienić jedną literkę ) , Kazimierza Wygrzywalskiego na Feliksa Wygrzywalskiego , Władysława Szernera jr . na ojca ( wymazując tylko " jr " ) , podobnie jak z prac córki Włodzimierza Tetmajera robi się obrazy taty .	prace
Z tej też przyczyny [MASK] i modlitwy formułuje się w czasie teraźniejszym .	afirmacje
Na mocy porozumienia z 5 listopada 1999 r . [MASK] uzupełniające magisterskie będzie prowadzić Uniwersytet Marii Curie Skłodowskiej .	Studia
Gdy nagle groźny [MASK] usłyszał : To lwy zwęszyły w puszczy przybysza .	pomruk
3 ) Jakie [MASK] nosiła Zosia z " Pana Tadeusza " ?	nazwisko
Teraz jednak swoje [MASK] przekuła w czyn - i pozew trafił już do londyńskiego sądu .	zapowiedzi
Jeszcze w połowie 1997 r . [MASK] rynku kontrolowało 26 największych hurtowni , a obecnie 50 proc . rynku należy do zaledwie pięciu firm .	połowę
W województwie wielkopolskim , zajmującym trzecie miejsce na liście najatrakcyjniejszych regionów , swoje [MASK] założyło 269 zagranicznych firm .	przedstawicielstwa
Obecny minister finansów oczywiście [MASK] nie robił w tej sprawie .	nic
Ponieważ nie posiadała pozwolenia na jej przewóz , [MASK] zatrzymano w depozycie .	muszlę
Poza tym tych delikatnych [MASK] nie zalewała minia i lakier .	wzorów
Kto tak ubrane [MASK] pozostawił w deszczowy , zimny i wietrzny dzień ?	dziecko
Tak np . [MASK] Państwa Kościelnego zawiadują w znacznym zakresie ludzie świeccy , choć niekiedy przysparza to Watykanowi poważnych kłopotów , a nawet strat .	finansami
We współczesnej dyskusji takie [MASK] stawiali H . Williams , N . Abercrombie , J . Larrain , W . Carlsnaes .	zarzuty
Pan będzie te [MASK] dementował , podawał sprzeczne informacje na temat miejsca procesu i jego daty . . .	plotki
Prawdopodobnie już w przyszłym roku [MASK] drogowe będą przeprowadzać nie tylko policjanci , ale również inspektorzy drogowi .	kontrole
3 . Które [MASK] wywozi się za granicę ?	towary
Przez wiele ostatnich lat te [MASK] ośmieszano i uznawano za coś , co nas nie dotyczy .	działania
Po zawarciu nowego pokoju w połowie trzynastego stulecia Swiętopełk nową , piątą z rzędu [MASK] rozpoczął .	wojnę
A jeśli przypadkowo będzie wiedział , to będzie [MASK] repetował .	rok
Na wczorajszej rozprawie [MASK] składali kolejni świadkowie w procesie , który niedawno został rozpoczęty ponownie .	zeznania
Oczywiście , niektóre [MASK] lepiej czyta się na papierze i dlatego przedwczesne okazały się obawy wydawców prasy .	rzeczy
Jakże mu ten [MASK] znaleźć ?	kluczyk
Ale w jakich sytuacjach i jakie rzeczy powinny się dziać , [MASK] niech już mi powiedzą te panie , przez które upił em się wtedy jak świnia , chcąc uniknąć skandalu .	to
Ten widok nawet [MASK] specjalnie nie przeraził - był tak surrealistyczny i nierealny , że mózg Zaniego po prostu nie przyjął go do wiadomości .	go
Po czterech godzinach [MASK] przerwano - tyle bowiem czasu dziennie , według lekarzy , może być sądzony Wojciech Jaruzelski .	rozprawę
Może by śmy [MASK] minęli , tak nas ta figura gdzieś ukryta przed nami pośród chałup , płotów , ogródków , drzew , krzaków zmamiła , lecz nagle jakby spod ziemi doszedł nas jego martwy głos : - Nie mówił em , że szukacie czegoś ?	go
Gdy odbywa służbę wojskową w Maroku , wielkie [MASK] robi na nim głęboka religijność wyznawców Islamu .	wrażenie
Tej dziwce zaś już [MASK] zada !	bobu
Za szkody wyrządzone w obwodach łowieckich - leśnych , [MASK] wypłacają Lasy Państwowe , a na terenach obwodów łowieckich - polnych i na terenach nie wchodzących w skład obwodów łowieckich - wojewodowie .	odszkodowanie
- Z tych też względów [MASK] materiałów kieruję do Najwyższej Izby Kontroli w celu szczegółowego zbadania .	całość
Jak Rosjanie wystrzelili swój pierwszy sputnik , taksówkarz [MASK] pyta : " Panie , pan wierzy , że ten sputnik poleciał ?	mnie
W sporządzanych na gorąco po kampanii wrześniowej zapiskach 19-latka [MASK] przedstawia jako bezładną szamotaninę : nocne czuwania , nocne strzelania , jakieś rozkazy , rozbiegani kurierzy .	wojnę
Ja osobiście nigdy by m [MASK] nie usunęła .	dziecka
Zagroda zaraz by [MASK] wsadził za kratki .	cię
W tym dniu [MASK] owocnych obrad przekazali zjazdowi przewodniczący delegacji partii komunistycznych i robotniczych z krajów socjalistycznych .	życzenia
Czemu więc ostatecznie [MASK] nie załatwiono ?	roszczeń
Tymczasem wczoraj kolejną [MASK] o współpracy asygnowali swoimi podpisami Piotr Kubieniec , dyrektor Zespołu Szkół im . Jana Pawła II i dyrektor szkoły podstawowej w Jaszbereny , od roku partnerskiego miasta Suchej Beskidzkiej .	umowę
Oczywiście nikt wcześniej [MASK] nie zauważył , nawet historycy we Włoszech , którym nie chciało się przekartkować dzieła Masiniego .	tego
– Każdego młodego [MASK] w kapturze uważa pewnie za bandytę .	człowieka
A jak jeszcze słyszę , że mam bulić komuś kasę , której nie mam , żeby mógł jeszcze bardziej monopolizować rynek , to [MASK] krew zalewa .	mnie
Do tej pory np . [MASK] izolowało się z trzustek zwierzęcych .	insulinę
W ciągu roku [MASK] czasu spędzamy w klimatyzowanych , sztucznie oświetlanych pomieszczeniach , zaś podczas dwutygodniowego urlopu za wszelką cenę chcemy nadrobić zaległości i " strzaskać się " na brąz .	większość
Co zrozumiałe , nihilizm Stirnera sam [MASK] rozpoznawał i afirmował jako emanację ostatecznego stadium procesu dziejowego , w którym nastąpić ma faktyczne zerwanie z wszelką formą " zaświatowości " i " rządami Ducha " .	siebie
Natomiast w biedniejszych dzielnicach [MASK] brukowano kamienną kostką i unosił się nad nimi stały hałas .	ulice
Prawie 100 tys . [MASK] wyasygnował budżet państwa dla gdyńskiej gminy na zakup podręczników dla najuboższych uczniów .	zł
A tak w ogóle to jak jeszcze jutro będzie siedział w tej brei to [MASK] spuszczę i kijem skórę wygarbuję , bo my tu żadnego podmiotu nie chcemy .	psy
Brutalnie amputowane z regionalnej pamięci [MASK] zastąpiono obrazami walących się galicyjskich wsi i przegranych żołnierzy na zabłoconych mazowieckich polach .	wspomnienia
Ale jakoś wszyscy [MASK] tutaj besztają za to i to w taki sposób jakby m arabom wysłał plany bomby atomowej .	mnie
A jak nakręci filmik , to [MASK] wrzuca na YouTube'a , a jak mu się nie chce , to nie wrzuca .	go
Gdy komunizm zbankrutował , [MASK] kupił za niewielkie pieniądze przedsiębiorczy biznesmen i zamienił go na ośrodek wypoczynkowy .	budynek
Przecież te kilkaset [MASK] stanu Floryda nieubłaganie absolutyzuje się w świadomości światowej opinii publicznej w ten sposób , że staje się reprezentacją , a nawet częścią wszystkich amerykańskich głosów .	głosów
Ze względu na lecznicze właściwości smoły ziemnej , którą balsamowano ciało , [MASK] proszkowano i dodawano do lekarstw .	mumię
Podczas miodobrania , świeży pachnący [MASK] degustuje się z plastrów , niemal prosto z ula .	miód
Kiedy dłużyła nam się zima , albo zbyt upalne lato dawało się we znaki , [MASK] pytali śmy o prognozy .	Jego
Z całym szacunkiem , kiedy rodzic traci dziecko , to [MASK] dobija .	go
W takich przypadkach [MASK] proceduralne niniejszej umowy stosuje się z uwzględnieniem niezbędnych zmian i przekazuje się wszystkie dostępne informacje dotyczące faktycznej tożsamości i obywatelstwa osoby , która ma być ponownie przyjęta .	postanowienia
Od dnia 1 lipca 1998 r . , [MASK] i załączniki do dyrektywy 64/432/EWG zastępuje się tekstem załączonym do niniejszej dyrektywy .	artykuły
10 Na mocy art . 1 rozporządzenia nr 1347/2001 [MASK] „ Bayerisches Bier ” zarejestrowano jako ChOG .	nazwę
Zgodnie z umową [MASK] taryfowe należy otworzyć na okres od dnia 1 stycznia do dnia 31 grudnia .	kontyngenty
Tydzień po zmrożeniu , trzy [MASK] z każdym szczepem wirusa rozmraża się pod zimną wodą i miareczkuje na odpowiednich liniach komórkowych .	probówki
Jednakże jeśli badanie zostało przeprowadzone przy większej prędkości uderzenia , a zostały spełnione ustanowione wymogi , [MASK] uznaje się za zadawalające .	badanie
Do celów wykonania Umowy następujące [MASK] uważa się za pochodzące z Byłej Jugosłowiańskiej Republiki Macedonii :	produkty
Jakby ś nigdy [MASK] wcześniej nie słyszał .	tego
Wielu obywateli będzie [MASK] postrzegać jako kolejny przykład , że elita UE robi dokładnie to , na co ma ochotę .	to
W przypadku pozyskiwania produktów we Wspólnocie , zapraszane [MASK] wybiera się spośród tych , które uczestniczyły w zaproszeniach do składania ofert określonych w ust . 2 .	przedsiębiorstwa
U ludzi zdrowych [MASK] pokarmowy wyściełają komórki zapobiegające wyciekowi treści z jelita .	przewód
- Niech ktoś [MASK] zrobi , bracie .	coś
" Ten brzydki Tom [MASK] nigdy nie rozdzieli .	nas
Jeżeli koszty odsetek są włączone do wyniku segmentu , odnośne oprocentowane [MASK] zalicza się do pasywów segmentu .	zobowiązania
. . . [MASK] myślał eś jak sobie walił eś .	co
A jak się drzesz na mnie , to [MASK] denerwujesz .	mnie
Ale po prostu tak bardzo [MASK] podziwiam . . .	cię
" To duchy [MASK] zrobiły , Wysoki Sądzie " .	to
A o co [MASK] oskarżą ?	nas
- A on czego tu [MASK] pcha ?	łapę
– ale ja [MASK] piję nadal . .	wodę
– Chyba zaraz [MASK] zastrzelę !	cię
Chętnie będziemy taką [MASK] wspierać słowem drukowanym !	inicjatywę
- Dlaczego mi [MASK] mówisz ?	to
Dlatego nigdy się [MASK] nie kąpie , bo mogą się przeziębić i zginąć .	ich
- Finek , skurczybyk , już [MASK] gdzieś schował .	się
– i już [MASK] nikt nie przeskoczył . .	nas
Laski od razu [MASK] zauroczyły .	mnie
Na wszelki wypadek [MASK] twardo dzierżą mężczyźni .	władze
Tylko jednego wspaniałego [MASK] Pan spotkał ?	nauczyciela
W którym stawie [MASK] kąpała ?	się
Wychowani na prymitywnych filmikach amerykańskich Polacy [MASK] uważają za siłę .	chamstwo
- Wysoki Senat [MASK] szesnastą odrzucił .	poprawkę
Żadna z nich [MASK] nie mówiła .	nic
W 2007 r . największy [MASK] odniósł film „ El Greco ” w reżyserii Yannisa Smaragdisa .	sukces
Przed cesarzem Meiji [MASK] er zmieniano częściej , a pośmiertne imiona cesarzy wybierano w inny sposób .	nazwy
Poza Japonią , począwszy od cesarza Shōwa , [MASK] często nazywano ich imionami , zarówno za życia , jak po śmierci .	cesarzy
10 marca 1896 r . [MASK] odwiedził wielebny William Hechler , anglikański kapelan ambasady brytyjskiej .	Herzla
W 2009 r . całkowitą [MASK] „ Potęgi teraźniejszości ” i „ Nowej Ziemi ” w Ameryce Północnej szacowano odpowiednio na 3 miliony i 5 milionów egzemplarzy .	sprzedaż
Do tego czasu rozrzutność i seria nietrafionych inwestycji jej inwestorów niemal [MASK] zrujnowały .	ją
W 1992 r . [MASK] dawnego teatru lalkowego , pozostawionego w rękach gminy , przejęli aktorzy i pracownicy .	tereny
W 53 . min dwójkową [MASK] przeprowadzili Krupa i Zięba .	akcję
Przez siedem lat [MASK] już sprywatyzowano .	wiele
W pięciu sklepach [MASK] nie znaleziono , przeszukiwania pozostałych trwają .	nic
Pan porucznik Barański [MASK] szuka .	pana
Ten barwny świat już [MASK] porwał , a ja , dobry tatuś z bajeczki , stał em się tylko przeszkodą .	ją
- No i [MASK] niby by m tam ujrzał ?	co
4 . W przypadku powiatów , w których liczba lekarzy weterynarii przekracza 150 , [MASK] wyborcze ustala Krajowa Rada Lekarsko - Weterynaryjna .	rejony
- Gdy przez telefon pytał em , kiedy mi zwrócą pieniądze , mętnie [MASK] tłumaczyli .	coś
W strukturze współczesnego systemu szkonictwa wyższego w Polsce państwowe i niepaństwowe [MASK] dzielimy na dwie kategorie .	uczelnie
O , o , ten [MASK] kupił em wtedy , kiedy rodziła się twoja mama , widzisz ?	znaczek
Nie , ona [MASK] robi z miłości , żeby ratować związek , żeby utrzymać tego faceta przy sobie , chce go chociaż tak zaspokoić , skoro nie potrafi w tym , co najważniejsze dla mężczyzny .	to
Będziemy wtedy przy pomocy OKA WIELKIEGO BRATA [MASK] śledzić i wiedzieć wszystko o wszystkich , tak samo , jak w " 1984 " roku w książce George,a Orwella .	wszystko
Radomski klub Jędrusiowie swoją [MASK] rozpoczął w październiku 1995 roku .	działalność
Na okoliczność wodowania [MASK] wymalowano nietypowo - kadłub pokrywały bowiem różnokolorowe farby antykorozyjne .	jednostkę
W rodzimej wersji tego filmu [MASK] głównemu bohaterowi użyczył Zbigniew Zamachowski , Osła dubbinguje Jerzy Stuhr , księżniczkę Fionę Agnieszka Kulikowska .	głosu
10 lipca 1941 roku [MASK] Laudańskiego wezwał burmistrz Karolak , rządzący wtedy miastem , aby zreperował mu piec , Jerzy stał pod stodołą , ale oddalony o trzydzieści metrów , przed nim - jak twierdzi - stało wiele innych osób .	Zygmunta
Zaś Jaspers też wielkie [MASK] przywiązywał do Plotyna , napisał książkę o Kartezjuszu , by go skrytykować , od młodości ciekawił się Spinozą , dla odmiany najpierw wiele znajdował w Heglu , by go potem skrytykować , a za to inspirację dla niego stanowiły poglądy Friedricha Schellinga , potem oczywiście Kierkegaard , Nietzsche , ale także Wilhelm Dilthey i Max Weber , a już po koleżeńsku Husserl i Heidegger .	znaczenie
Po poznaniu anatomii tętnic wieńcowych [MASK] z UA/NSTEMI w ciągu 72 godzin od wystąpienia objawów lub ze STEMI w czasie od 12 godzin do 14 dni od wystąpienia objawów poddawano randomizacji .	pacjentów
