Bez tohoto dokladu vám spoje ani firma s licencí [MASK] nepřipojí .	přístroj
A protože už uplynula doba , po níž lze očekávat první výsledky působení nového tatrováckého vedení , [MASK] s nynějším předsedou představenstva a generálním ředitelem Tatry Kopřivnice Geraldem Greenwaldem ( na snímku ) jsme začali otázkou vztahující se k prvnímu úkolu :	rozhovor
A z toho , kdo peníze nebo jiný majetek nemá , [MASK] nevynutí .	dluh
Ze stálého počtu potřebných třiceti pracovníků [MASK] jich asi deset vystřídalo .	se
Přesně v souladu s Komenského " Škola hrou " [MASK] děti učí slovní zásobě jednotlivých tématických okruhů .	se
Jaká šance se v tomto směru otevírá i pro české obchodníky a výrobce , o tom [MASK] napoví reportáž redaktora Profitu , který Thajsko navštívil .	mnoho
Po příchodu domů jsem si celou [MASK] rozmyslel a chtěl bych se proti rozsudku odvolat .	věc
Jestliže nelze platební rozkaz doručit do vlastních rukou i jen jednomu z odpůrců , předseda senátu [MASK] usnesením zruší v plném rozsahu .	je
Jeho kolega z Národního divadla Josef Vinklář sice [MASK] v pánském oblečení nijak zvlášť neakceptuje , ale slova uznání k těm , co to ovládají , vždycky najde .	dění
Ovšem pár dioptrií a moderní obroučky [MASK] spravily .	to
Nicméně ve vývoji kurzů akcií obou společností [MASK] postupně prosadil trend společný celému oboru .	se
Jak vyplývá z vašeho dopisu , [MASK] občanství jste sice splňovala , podmínku bydliště však ne .	podmínku
S právnickým vzděláním , když navíc nepřinesl papír , že o nábytku něco ví , [MASK] měl těžké .	to
Poté , co si sám ověřil stav v Krnově , [MASK] omluvil .	se
Při provozu od 7 do 23 hodin [MASK] denně při 120 místech vystřídá na 800 hostů .	se
Pokud se hovoří o otevřenosti , tak [MASK] chápejte jako zásadu , že fond garantuje každému podílníkovi , že na požádání mu jeho podíl zpětně odkoupí .	ji
Sousedi , kteří koupili vloni až ve čtvrtém kole kuponové privatizace za tisíc bodů po 360 akcií tolik znevažovaný ČKD Praha , [MASK] všechny po 340 korunách před nedávnem na burze prodali , a teď se jenom hádají , zda má mít jejich nový Favorit za utrženého skoro čtvrt milionu 50 kW motor , katalyzátor a spoiler , nebo ne .	je
Pracovnice , které majitelka našla stejně placenou práci jinde , její [MASK] odmítla a raději si nechala odstupné vyplatit .	nabídku
Kdo by měl " svrbění " tento čin opakovat , ať si [MASK] raději dvakrát rozmyslí : Sazby jsou totiž " solidní " a " každý má právo na ochranu před neoprávněným shromažďováním , zveřejňováním nebo jiným zneužíváním údajů o své osobě . " Tolik článek 10 odst . 3 Listiny základních práv a svobod .	to
Pokud máte k dispozici jen jednu knížku , zbytečně [MASK] nerozptylujte .	body
Otec , zajišťující garde i dopravu , [MASK] tam potká se svým dávným přítelem a vypije o skleničku více .	se
Zničující pohled a následná slova matky [MASK] přivedou do reality .	jej
Například rozeslání tisícovky akvizičních dopisů , na něž odpoví tři čtyři desítky potenciálních zákazníků , sice samo o sobě [MASK] nepřinese , ale přivede několik zákazníků , kteří ho uzavřou .	obchod
Úřednice mi po krátké poradě s nadřízeným s úsměvem a profesionalitou [MASK] vymění .	bankovku
Za potíže , které cestujícím zpožděním vlaku vznikly , [MASK] omlouváme .	se
Když by se podařilo snížit daně o 5 procent , [MASK] už bychom v provozu pocítili .	to
Vlastním sběrem polodrahokamů by však svoji [MASK] neuživili .	firmu
Zájem o spony na kravaty a brože tento [MASK] podpořil .	záměr
Když se vrátil na kontinent , získaná výrobní [MASK] úspěšně využil .	tajemství
Všichni , kdo toužíme po absolutnu , [MASK] přijímáme se skřípotem zubů - nedá se nic dělat , u kvantové kočky lze zjistit buď polohu , nebo rychlost a dost .	jej
. . . při četbě článku J . Bednářové " Pouštní a skalní laky " ( Vesmír 71 , 398 , 1992 / 7 ) [MASK] hned na začátku velmi nepěkně překvapila věta " Nejčastěji dochází k zátekům ( ! ! ) drobných . . . "	mě
úryvek z jednoho článku ve Vesmíru [MASK] pěkně ilustruje : V důsledku tohoto rozštěpení dochází ke ztrátě toxické aktivity botulitoxinu .	to
Do odborné i populárně - osvětové literatury [MASK] uvedl r . 1791 J . Long .	jej
Tyto pro normálně slyšícího člověka indiferentní [MASK] považují neslyšící za velmi příjemné .	zvuky
* Když ohříváte dříve vařené pokrmy , dobře [MASK] povařte .	je
Její roli jsme si po dlouhou dobu příliš neuvědomovali ( nebo jsme o mozku nevěděli dost pro to , aby bychom si tuto roli uvědomit mohli ) , její [MASK] jsme značně opomíjeli a v důsledku toho o ní nevíme téměř nic .	význam
Neustálé narážení na " složitost " [MASK] vede přímo k otázce " co to vlastně je složitost mozkových procesů a jaký je její význam pro pochopení jejich fyziologické role ? " .	nás
Za 9 let soustavné práce L . Montagnier svůj [MASK] jistě dobře poznal .	virus
Zatímco v tropickém podnebí Evropy bujely uhlotvorné pralesy , [MASK] pokrývaly pralesy mírného pásu .	Austrálii
Ačkoli Wigner nakonec paradox odmítl , neboť implikuje , že jeho přítel neexistuje , dokud jej Wigner neuzná , Talbot [MASK] přijímá v jeho plném důsledku .	jej
Účelové " chování u E . coli [MASK] překvapilo možná proto , že myšlenkové ovzduší moderní biologie po léta nepřálo tématům , která neblaze upomínala na Lysenka .	nás
V Ilustrovaném encyklopedickém slovníku ( Academia , Praha 1980 ) jsem [MASK] nenašel , ale je tam aserce : " vyjádření uznání , že nějaký výrok je pravdivý ;	asertivitu
Důsledky sociálního inženýrství , dokumentované v Johnsonově knize , toto Hayekovo [MASK] přesvědčivě dokládají .	tvrzení
( Otázka , co je to vlastně za literaturu , [MASK] se Zdeňkem tehdy přivedla k pokusu napsat rozbor tohoto žánru , pro nějž jsme si vymysleli název " Fi Fi " - filozofická fikce .	nás
Přestože na ně bylo podle pokynů profesorských sborů univerzit vynaloženo velké množství peněz i úsilí , mnoho [MASK] nepřineslo .	užitku
Druhý chlapec , s uchovanou alespoň druhou spojkou ( měl ji vyvinutou nadměrně ) , [MASK] těchto přesunů neměl .	poruchy
V rozporu s obecně zafixovanou představou však nejzávažnější [MASK] nepředstavují aditivní látky , ani chemické kontaminanty prostředí vstupující do potravinových řetězců , ale spíše látky s přirozeným výskytem , komponenty utvářené v průběhu technologických postupů či produkty vznikající endogenně na základě metabolických procesů .	riziko
Po úspěšném potlačování mouchy na jednom kontinentě [MASK] najednou překvapí jinde .	nás
Přestože mají blíže k špačkům , anglický název [MASK] řadí mezi " kosy " ( red - winged blackbirds ) .	je
Když však zazněly výroky o proměně biologické informace na elektromagnetickou , někdo [MASK] nevydržel a sálem zaznělo : " Pane , jste blázen a já odcházím ! "	to
Jaký chemický signál však tyto podpůrné [MASK] probudí a způsobí , že se začnou množit ?	buňky
Zatímco téměř polovina okresů ČR vykazuje v rámci celé republiky nejvyšší hodnoty ( 28 okresů ČR leží ve IV . kvartilu ) , na Slovensku [MASK] do tohoto kvartilu zařazuje pouze jediný okres , Trebišov .	se
Pod vlivem ledvinového hormonu erytropoetinu si jejich tělo chybějící [MASK] nahradí , protože erytropoetin povzbuzuje tvorbu červených krvinek v kostní dřeni .	krev
Naproti tomu jeden ze dvou světlonošů umístěných u paty schodiště investiční banky postavené národně orientovanou buržoazií v letech 1894 - 96 válečnou [MASK] má ( 50 % ! ) .	sekeru
Působení vodní a větrné eroze jakož i tektonická aktivita Země [MASK] poměrně rychle vymaže , takže nejpozději za 100 miliónů let kráter dokonale zmizí .	krátery
Nicméně ve čtvrtek 17 . 9 . 1992 [MASK] doporučily ústavněprávní výbory Federálního shromáždění sněmovnám ke schválení .	jej
Podle nezávislého odborníka , který nechce být jmenován , slovenští policisté " zřejmě na vyšší příkaz [MASK] předem připravili na rozbití tábora Ferencvárosu , ale některé jednotlivce z řad maďarských návštěvníků zbytečně provokovali , neboť oni sami dali dostatek záminek k jinak nepochybně brutálnímu a nelidskému zákroku " .	se
Naopak Dánové jako nečekaní fotbaloví mistři Evropy [MASK] Fortuny potěšili .	pokladnu
Nedělní referendum ve Francii podle jeho názoru se svým absurdním těsným výsledkem podporujícím " Maastricht " [MASK] v podstatě potvrdilo .	to
Čím více se ale Evropa mění , tím [MASK] jistot , jak se zdá , nabízí .	méně
Přestože jeho současný zdravotní stav , operace prostaty a nález rakovinného nádoru , by [MASK] dostatečně zdůvodnil .	demisi
Poznání , že partnerství v ES má nepřekročitelné meze , by členské [MASK] vedlo k tomu , aby by začaly více sledovat a prosazovat vlastní zájmy .	země
Jen deset procent účastníků průzkumu tuto [MASK] naprosto odmítá .	tezi
A ze stejně neřešitelného dilematu , tentokrát v otázce " Evropa ano , či ne " , bude [MASK] Švýcarů bolet hlava i před prosincovým hlasováním .	spoustu
Ti individuální investoři , kteří si výpisy nevyzvedli osobně , [MASK] obdrží v průběhu července prostřednictvím pošty .	je
Letecká společnost AIR Vítkovice , která stejně jako ČSA pravidelně létá z Mošnova , [MASK] za odbavení nezavedla .	poplatky
Vojenská obvodová prokuratura v Českých Budějovicích trestní [MASK] Jaroslava Bašty zastavila .	stíhání
Ani čtyři horské prémie toho však [MASK] nepřinesly , aktivitou hýřili jen zahraniční jezdci , zatímco domácí závodníci se spíše hlídali .	mnoho
A když si na jednu loď zvyknu , nerad [MASK] měním . "	ji
Podle Ivana Vihana , hajného z polesí Pec pod Sněžkou , slovenští dělníci tuto [MASK] splňují .	podmínku
Do své edice Velcí čeští dirigenti představují . . . tento [MASK] zařadil Panton .	snímek
A tak zatímco Křeček odpadl z prvního místa zejména proto , že měl jen jeden doprovodný vůz a nestihl v potřebný okamžik vyměnit pneumatiky , [MASK] Blahnu provázely tři vozy a druhého v cíli Valouška dokonce šest .	vítěze
Pokud se týká věku , jisté [MASK] jsem si přinesl z Eindhovenu , kde jsem měl možnost pozorovat vynikající spoluhráče , kterým bylo tolik jako dnes mně .	zkušenosti
" I když trenérem Sparty bych byl nejraději , jinou [MASK] pochopitelně připouštím .	eventualitu
Z mistrů světa 1991 ve slovinském Tacenu [MASK] znovu získal jen německý kanoista Lang .	titul
Všech 19 občanů Indie ve věku 18 až 22 let [MASK] prokázalo doklady na totožné jméno Singh .	se
Milan Hruška , který je dnes okresním policejním ředitelem , možné [MASK] ze spekulace důrazně odmítl .	obvinění
Zemědělské družstvo v Tečovicích na Zlínsku svá [MASK] pohání bioplynem .	vozidla
Další pumové atentáty na banky a jiné objekty v Londýně tento [MASK] pouze posílily - zvláště vzhledem k hospodářské krizi , v níž se Británie už třetí rok zmítá .	pocit
Jižní Korejci si ve své většině [MASK] přejí , a dokonce velmi neradi slyší , hovoří - li se špatně o bratřích a sestrách ze severu .	sjednocení
Jižní Korejci si však ve své většině [MASK] přejí a dokonce velmi neradi slyší , hovoří - li se špatně o bratřích a sestrách ze severu .	sjednocení
Dokonce ani na tzv . velké burze , která byla donedávna těmito výrobky přesycena , " černou " [MASK] nekoupíte .	kazetu
Jak nám včera řekl prokurátor , který se případem zabývá , oba [MASK] zavraždil zvlášť surovým způsobem , který je pro tak nízký zisk neobvyklý .	muže
V neděli ve dvě hodiny v noci [MASK] v Ostravě - Mariánských Horách napadl neznámý pachatel .	ho
Na tiskové konferenci neformální skupiny věřitelů Bohemie [MASK] včera řekl bývalý poslanec FS Jiří Svoboda .	to
Mluvčí České spořitelny Pavel Jiroušek nám tuto [MASK] ani nepotvrdil , ani nevyvrátil .	informaci
Podle informací , které mají LN k dispozici , [MASK] stále šetří policie a spis dosud nebyl předán vyšetřovateli .	případ
Jak jsme již v LN informovali , [MASK] na výplatu dividendy mají akcionáři , kteří byli držiteli akcií IPB dne 22 . 4 . 1994 .	nárok
Proti předešlému roku však podnik úvěrové [MASK] snížil o více než 22 milionů korun .	zatížení
Po dobu dvou let v době sezonních prací [MASK] navštěvují synkové ze statků jednou týdně , v dalších dnech pomáhají otci na farmě .	ji
Ježto vězňové nemají prakticky žádný příjem a nemohou být zkráceni o svá ústavní práva , automaticky [MASK] kvalifikují na příjemce této nadace .	se
Nedělní vystoupení JOSÉ CARRERASE a MONTSERRAT CABALLÉOVÉ v pražském Rudolfinu ( na rozdíl od večera Plácida Dominga ve Sportovní hale ) tuto [MASK] skutečně naplnilo .	potřebu
Argumenty odvozenými z věcné analýzy tržního procesu , v němž živelnost již střídá seberegulace , usměrňovaná konkurencí i legislativou , [MASK] ovšem na sjezdu korigoval předseda Ruského výboru pro kinematografii Armen Medveděv .	je
Oba sólisté Jan Hališka ( Stamitz ) a Miloš Sádlo ( Rejcha ) romantické [MASK] zdůrazňují svým individuálním cítěním zejména v pomalých středních dílech .	prvky
Za výkon , který jsme od 25 . minuty předváděli , jsme si [MASK] zasloužili .	výhru
" Už druhý den ráno po operaci [MASK] vyhnali z postele a musel jsem na příkaz lékařů chodit .	mě
" Jak ale Šmicer dodal , nucenou [MASK] nevyužije jako jeho spoluhráč Berger - na ženění je prý brzy . . .	pauzu
Na Lékařské fakultě v Brně však [MASK] nedělají .	rozdíly
Nová kniha ruského prezidenta Borise Jelcina [MASK] odhaluje jako člověka trýzněného depresemi a pochybnostmi , jenž je stejně přísný na své podřízené jako kritický k sobě .	jej
V souvislosti s vydáním Jelcinových pamětí ve Velké Británii [MASK] včera uvedla agentura Reuter .	to
Protestantská komunita v Severním Irsku tuto [MASK] ostře kritizovala .	návštěvu
Tato skutečnost však podle odhadů zásadní [MASK] nepřinese .	změnu
Že autorka zcela pomíjí aspekty filozofické a etické [MASK] nepřekvapilo tolik jako to , že zde prezentuje i řadu závažných nepravd a polopravd a celý tento problém ve výsledku zjednodušuje a zlehčuje .	mne
k Jihlavě , kde se jeho otec posléze uchytil jako prosperující živnostník , [MASK] poutal prožitek prvních patnácti let života .	ho
Jestliže by při jejich penzionování porušila zákon , [MASK] by podle Nekvasila určitě prohrála .	soud
Ve středu Fond národního majetku , který je stoprocentním majitelem Poldi Kladno Holding , její [MASK] vyměnil .	vedení
Jeho výkony v tehdejším play off o titul , kdy ze čtvrté pozice v základní části se celek vyšplhal k titulu , domácí [MASK] šokovaly .	veřejnost
Ale zlepšené výkony ve druhé polovině soutěže [MASK] ze sestupu smazaly .	obavy
Podle předního ukrajinského ekonoma Oleha Soskina však v září [MASK] postihne růst inflace do 50 až 60 % .	zemi
Na sobotních Ústředních oslavách 50 . výročí SNP [MASK] prohlásil prezident Michal Kováč , který dále uvedl , že význam SNP neztratil svou aktuálnost , protože i v našem prostoru se derou do popředí síly extrémního nacionalismu , netolerance , xenofobie a antisemitismu .	to
Ve Světovém poháru minutových filmů si [MASK] odnesl rakouský snímek Die Falle .	vítězství
I u průmyslové a stavební výroby nejlepší [MASK] dociluje polská ekonomika .	výsledky
V sobotu během zasedání předsednictva unie a zástupců ČMSS [MASK] řekl předseda LSU František Trnka .	to
K návrhu zákona na věčně vyrovnaný rozpočet ale Klausovu [MASK] nevedly ekonomické , nýbrž průhledné politické motivy .	stranu
I když delegace prohlašuje , že Prosincová deklarace - výsledek mírové iniciativy Reynoldse a Majora - bude základním kamenem budoucího míru , jejich úzké vztahy s IRA , Sinn Fein a Adamsem [MASK] jistě netěší .	Londýn
Výbuchy , které si vyžádaly nejméně deset raněných , [MASK] naznačují .	mnohé
Jen několik týdnů před povstáním hlavního města [MASK] výbor jeho organizace Svobodná Francie přejmenoval na vládu .	se
Z libereckého zápasu si prý žádné velké [MASK] neodnesl , protože z mlhy , která se vytvářela nad ledem , měl neustále zapocené plexisklo . . .	dojmy
Americký hráč Alexi Lalas , účastník letošního mistrovství světa a v současné době hráč Padovy z italské nejvyšší soutěže , [MASK] přivítal , ale dodal , že se spolu se svými spoluhráči pokusí Angličany porazit bez ohledu na finanční efekt .	nabídku
Liberecké vítězství ( 3 : 2 ) a děčínská remíza ( 2 : 2 ) se sice jako žádné zázračné [MASK] nejeví , ale při bližším prozkoumání nejsou tak špatné .	výsledky
I když by se do zahájení turnaje Pragobanka Cup vztahy mezi vedením a týmem urovnaly , žádného [MASK] Zlína nenominujeme .	hokejistu
Měsíc po převzetí podniku , jehož 51 procent získala rozhodnutím vlády firma Inpro , [MASK] řekl generální ředitel ČKD Jiří Maroušek .	to
S odvoláním na mluvčího chorvatského ministerstva vnitra [MASK] včera uvedla slovinská agentura STA .	to
O zájmu Moskvy na zastavení válečných operací v Bosně včera bosenské [MASK] při své návštěvě bývalé Jugoslávie ujistil ruský ministr zahraničí Andrej Kozyrev .	vedení
Naopak muži , kteří se obávají pohlavně přenosných nemocí , dámský [MASK] vítají , protože pak sami nemusejí používat prezervativ .	kondom
Kulturní spolek , v němž se sdružují rumunští Češi a Slováci , [MASK] nerozdělil ani po rozpadu ČSFR .	se
V největším městském volebním obvodě Banja Luka své [MASK] řeklo 94.4 procenta voličů , zatímco pro ano se rozhodlo jen 4.81 procenta .	ne
Až teprve bezchybný výkon příslušnic Národní gardy v Perském zálivu tuto [MASK] radikálně změnil .	situaci
Při své nedávné plavbě po Volze ruský prezident Boris Jelcin [MASK] veselého neviděl .	mnoho
Vždyť právě Nizozemci , ale i Francouzi , Američané a další cizinci [MASK] důrazně nabádají k zachování toho , co jsme dlouhodobě budovali a co oni ve svých zemích postrádají : po celou divadelní sezonu denně kvalitní představení na stálých scénách v kamenných divadlech .	nás
Skupina Soul Asylum , která existuje již celé desetiletí , [MASK] prosadila albem Grave Dancers Union a především koncertní činností .	se
Tajemník ministra Tigrida Pavel Lagner však tuto [MASK] ještě včera v podvečer popřel .	informaci
Na závěr nizozemsko - české konference věnované vztahu státu a kultury , která se od 25 . do 27 . srpna konala v Jindřichově Hradci , [MASK] včera uvedl náměstek ministra Josef Svoboda .	to
V nastavší džungli ovládané dravci s cizáckými a špatně vyslovitelnými jmény [MASK] Kudlín a Schlín , poslední hlasatelé národní svébytnosti , udrželi jakoby zázrakem .	se
Pokud se v rámci nejnižšího stupně tržní hierarchie chovají slušně , neformální společnost trhovců [MASK] svým způsobem uznává a odměňuje je zbytky potravin , poskytne jim i místo ke spánku .	je
Ve věci této reklamy nikdo vlastně zatím [MASK] nepožádal o názor .	Radu
Podle posledních výzkumů veřejného mínění reálnou [MASK] dostat se do parlamentu má pouze 8 politických subjektů .	šanci
S odhadovaným výstavem piva 140000 hl pro letošní rok [MASK] řadí mezi malé pivovary .	se
Jak řekl LN velitel vsetínské městské policie Josef Jirků , značný [MASK] na narušování veřejného pořádku mají romští spoluobčané .	podíl
V rozhovoru pro agenturu Associated Press [MASK] uvedl bosenský premiér Haris Silajdžič .	to
Anebo že by vědečtí pracovníci tohoto ústavu [MASK] neznali ?	latinu
Přes údajné předběžné požehnání tohoto kroku právníky [MASK] považuji nejen za neetický , ale s nenulovou pravděpodobností úspěchu také za žalovatelný .	jej
Po včerejším slavnostním zahájení VII . mistrovství světa v plaveckých sportech v areálu Foro Italico dnes vlastní [MASK] zahájí vodní pólistky a skokani kvalifikacemi .	soutěže
Podle našeho zdroje zvláštní služby ministerstva obrany své [MASK] několikrát upozornily na rostoucí pozice zahraničních firem v odborech ministerstva , které rozhodují o výběru dodávek pro Čs . armádu , avšak bezvýsledně .	šéfy
I dojné krávy si mezi sebou [MASK] řeknou - už mi to řekly .	všecko
D . Ryppel , ředitel o . z . Lacmo Zlín , která nakupuje 35 procent surového mléka na Uherskohradišťsku , tuto [MASK] potvrdil a dodal : Jsme v platební neschopnosti jako drtivá většina ostatních českých mlékáren .	skutečnost
O zvýšení dovozních cel a zavedení dovozních kvót jsme [MASK] průmyslu a obchodu ČR požádali letos v únoru .	Ministerstvo
V okamžiku , kdy vstoupil na trh český výrobce , západoevropští vývozci jejich [MASK] prudce snížili .	cenu
Jak LN sdělil ředitel pražské chemické průmyslovky , školy [MASK] řeší většinou svépomocí a pak si publikace vyměňují mezi sebou .	to
Bude - li zastupitelstvem přijata koncepce , o níž primátor hovořil , nebude město další [MASK] stavět samo .	byty
V červenci , před odesláním nominace , jste tedy již aktuální [MASK] hospodaření zmíněného peněžního ústavu nepřezkoumali ?	stav
Výhrůžky spolu s plakáty podepsanými republikánskou stranou , kde se v moři hákových křížů vyjímala orlice cupující v drápech Českou republiku , [MASK] zneklidnily .	starostu
Americké pobřežní hlídky po vytažení běženců [MASK] zapalují a potápějí , aby by nebránily provozu .	lodě
Pět hlavních polovojenských skupin kubánských emigrantů v USA [MASK] zmobilizovalo v posledních týdnech .	se
Ani u ruských novinářů , ani u veřejnosti to však velké [MASK] nevyvolává .	nadšení
Nový Sejm , který vzešel z loňských zářijových voleb , tento [MASK] před prázdninami novelizoval , takže jeho nová liberálnější verze už připouští umělé přerušení těhotenství i z tzv . sociálních důvodů .	zákon
Většina bangladéšského muslimského obyvatelstva by za normálních okolností inkriminované [MASK] samozřejmě vůbec bývala nezaznamenala .	interview
Ačkoliv jsem pouze běžným nevelkým klientem Komerční banky a žádný termínovaný vklad u této instituce nemám , její jednání [MASK] uráží .	mne
Snad s věkem ( necelých 32 let - pozn . red . ) si tuto [MASK] ulehčuje a začíná se stahovat mezi obranu a zálohu .	úlohu
Jak ale LN sdělila pracovnice magistrátu Kamila Veselá , [MASK] tu pamatují naposled asi před pětadvaceti lety .	bourání
Podle Miluše Luňákové z odboru trhu práce však největší [MASK] žadatelů očekávají v následujících dvou týdnech .	nápor
Přestože je mu dnes pouze 30 let , pracovní [MASK] na Ukrajinu neplánuje .	návrat
Kromě klasických konzumních výrobků ( mléko , smetana , máslo ) [MASK] v současné době tvoří například pudinkový krém Pudík , ovocný dezert Bon , smetanové máslo s rostlinným tukem 6 + 4 , pudinkový dezert Duola nebo zakysaná smetana se zeleninou .	ho
Po své včerejší schůzce s ministrem kultury Pavlem Tigridem [MASK] řekl ministr financí Ivan Kočárník .	to
Nakonec , díky amnestii , si [MASK] neodpykal nikdo .	trest
Jak jsme včera informovali v LN , oba [MASK] vydala ve středu slovenská strana k trestnímu stíhání v České republice .	muže
Představitelé ruského ministerstva pro atomovou energetiku toto [MASK] rozhodně popřeli a potvrdili své středeční údaje .	sdělení
Tak jako už častokrát v minulosti spásný [MASK] našel a všem nabídl izraelský ministr zahraničí Šimon Peres .	žebřík
Josef Moucha , Ivan Pinkava , Tono Stano , Václav Stratil a další [MASK] představí na výstavě fotografií V ostrém světle , která je od dnešního dne otevřena v Pražském domě fotografie v Husově ul . a potrvá do 27 . září .	se
Přes povinný happy end tentokrát možná [MASK] řidiče v kabině rozjetého stroje obsadil sarkasticky se ušklíbající ďábel .	místo
S hostitelským muzeem a německým Werkbundem [MASK] připravila Projektová skupina mateřských škol při frankfurtském magistrátu .	výstavu
Ruská nákladní loď Progress M - 24 [MASK] včera spojila s orbitálním komplexem Mir .	se
Přestože moderátor známé televizní relace Policie České republiky poručík Petr K . popírá , že by se dopustil trestného činu , jeho [MASK] převzal pražský úřad vyšetřování .	případ
Ač si americká tenistka Zina Garrisonová přišla na kurtech na víc než čtyři miliony dolarů , svůj [MASK] 2 . kola na US Open málem absolvovala naboso .	zápas
Přestože se prý zpočátku v nových botách cítila jako kachna , [MASK] bez problémů vyhrála .	zápas
Když by ale nový předseda prosadil do funkce jiného trenéra , [MASK] byste dělal ?	co
I když bych měl stejné možnosti , dlouhodobá [MASK] bych rozhodně nevolil .	soustředění
Magistrát hlavního města Prahy , který několik použitelných objektů vlastní , třeba Grébovku v Havlíčkových sadech , velký [MASK] o nadané děti nejeví .	zájem
Jakkoliv mé vystoupení ve Würzburku obestírala krásná a klidná pohoda , tak o rok pozdější mou [MASK] v Heidelberku ve velké posluchárně tamní proslulé univerzity , k níž patřil i Institut pro studium slovanských jazyků a literatur , provázel protest , napadení skupinou posluchačů a jejich mluvčí vystoupil proti mně velmi adresně , a i když více méně zaobaleně , i hrubě .	přednášku
Bývalý redaktor jednoho východoberlínského vědeckého časopisu Joachim Pampel ( 52 let ) [MASK] nejen volil , ale dokonce do ní vstoupil .	PDS
Z jedné diplomatické štace na druhou [MASK] provázejí mé knihy , psací stůl a na dně jeho zásuvky červená pastelka , knoflík od košile , kterou jsem snad ani nikdy nenosil , jakési telefonní číslo z Moskvy roku 1967 . . . atd .	mě
působení v exilových rozhlasových stanicích Svobodná Evropa a Hlas Ameriky mu tento [MASK] umožňovalo nejen fakticky předáváním informací , ale i emocionálně .	kontakt
KDS však podle šéfa svého klubu M . Bendy žádné vyvlastňovací [MASK] nepodpoří .	řešení
Ivan Lendl , který nezačne servírovat , dokud v tichu neslyší soupeřův dech , [MASK] raději z jednoho turnaje odhlásil .	se
Ať ho lidé milovali či nenáviděli , vždy [MASK] John McEnroe fascinoval .	je
Pětatřicetiletý Američan sice prý ještě definitivně [MASK] nezabouchl , ale svůj návrat na kurty nepovažuje za reálný .	dveře
Na extrémně kopcovité cyklistické trati svůj [MASK] výrazně zvýšil , podle svých slov zajel snad nejlepší kolo v životě .	náskok
Francouzský fotbalový bouřlivák Eric Cantona , který za deset let vystřídal devět klubů , [MASK] zřejmě upíše svému stávajícímu zaměstnavateli Manchester United až do konce fotbalové kariéry .	se
Ale ani tři zbývající týmy skupiny toho spolu [MASK] nenahrály , i když startují jak v kvalifikaci ME , tak MS od vzniku soutěží .	moc
Za dosavadních podmínek na tom byli , jsou a budou prvovýrobci vždy [MASK] , řekl Jiří Nožička .	biti
Sergej Alexašenko , náměstek ministra financí a přívrženec rozsáhlých tržních reforem , [MASK] svého nadřízeného odmítl a k celé záležitosti se staví s notnou dávkou skepse .	návrh
V sobotu totiž předáci bosenských Srbů papežovu [MASK] zpochybnili , když se odmítli zaručit , že na něj nezaútočí .	návštěvu
O víkendu , kdy zde uspořádali den otevřených dveří , o tom [MASK] LN informoval ředitel školy pplk . J . Šilpoch .	zpravodaje
Před svou cestou na mezinárodní konferenci o populaci OSN v Káhiře , která se koná 5 . až 13 . září , [MASK] řekl náměstek českého ministra práce a sociálních věcí Jaroslav Dostal .	to
Už v roce 1991 jsem jednu [MASK] své knížky Nemám rád katastrofické scénáře ( Šagit , Ostrava , 1991 ) nazval Novozélandské vidění problémů a zdůrazňoval jsem , že jsem po několika hodinách diskusí s Rogerem Douglasem pochopil , že v řadě věcí nejde o pouhé podobnosti , ale o naprosté totožnosti .	kapitolu
BBC , nejklasičtější veřejněprávní televize světa , [MASK] nevysílá .	reklamy
S odvoláním na důvěryhodné zdroje v Dublinu [MASK] oznámila agentura AFP .	to
Náměstek ministra zahraničí USA Strobe Talbott [MASK] haitským generálům , aby by dobrovolně opustili ostrov , opakoval .	výzvu
To , že zkušenosti doslova všech průmyslových zemí svědčí o opaku , [MASK] nijak nevzrušuje - podle jeho názoru je to tím , že Američané , Japonci , Němci nebo Angličané prostě nepochopili , jak má správný kapitalismus vypadat , a je tedy nejvyšší čas , aby by se přijeli do Prahy poučit .	jej
Soudci krajských obchodních soudů však jeho [MASK] tehdy zpochybnili .	výrok
Značkové firmy , které mají autorizované zastoupení a prodej na našem území , českými návody dovážené [MASK] vybavují .	zboží
Odborníci na ústavní právo ale podobně dogmatický [MASK] ústavy odmítají a volí kompromis .	výklad
I když volební program sociálních demokratů se zdá sociálně vyváženější , přesvědčivý [MASK] na odstranění nezaměstnanosti rovněž nemají .	recept
Svatý Petře , já jsem ale [MASK] Užhorodu nikdy neopustil .	bránu
Poté , co ji loni nafackoval , napadl s nožem v ruce jejího přítele a popral se s pařížskými pořadateli , [MASK] sice Mary zapudila , ale Jim je nezmar .	ho
Po výhrůžce , že s ní zúčtuje ve Wimbledonu , Pierceová svůj premiérový [MASK] na dvorcích All England Clubu odvolala a raději obeplula na jachtě Korsiku .	start
Zda bude ze samovaru pít nápoj vítězky či poražené , [MASK] ukáže dnešní čtvrtfinále .	to
Zásoba 233 kubíků dřeva na hektar lesa [MASK] řadí na třetí místo v Evropě za Švýcarsko a Rakousko .	nás
S odkazem na informace mluvčího společnosti [MASK] uvedla agentura AP .	to
Včera po příletu na výcvikovou základnu mírových sil OSN v Českém Krumlově [MASK] řekl prezident Václav Havel .	to
Sdružení ustavené v roce 1991 svůj [MASK] odvozuje od toho , že jej z 95 procent tvoří někdejší členové ROH .	nárok
Jak Lidovým novinám sdělil náměstek Zeman , ministerstvo vnitra zatím celou [MASK] bedlivě sleduje prostřednictvím přednosty Okresního úřadu v Třebíči Karla Müllera .	záležitost
Ředitel pražského gymnázia Na Pražačce M . Macek [MASK] nepopírá .	to
Obsah vyjádření prvního náměstka ministra financí ČR ( LN 3 . 8 . ) k mému článku ( LN 13 . 7 . ) [MASK] nutí znovu reagovat a učinit několik poznámek .	mě
Špatná ekonomická situace po ukončení škol a studií [MASK] k tomu podle jejího názoru bude těžko stimulovat .	je
Jak vyplynulo z vyšetřování , oba Turci si [MASK] vymysleli .	přepadení
Nový majitel , soukromá akciová společnost , kterou z velké části vlastní bývalý právník Státního pedagogického nakladatelství František Talián , si [MASK] pořídil za desetinu této sumy .	je
Určitě snížení stropu pro zastoupení studentů [MASK] nemění na významu jejich práce v senátech , což je zaručeno návrhem na povinné zastoupení alespoň dvěma zástupci .	nic
Existující kanalizační sítě by totiž podzemní [MASK] vtlačily tak hluboko do země , že by jí jistě nikdo nepoužíval .	chodbu
Pražská 5 , volné generační sdružení několika divadel , hudebních i tanečních těles a jejich spřízněných duší , [MASK] příští týden v reprezentativním výběru představí vídeňskému publiku .	se
Přednosta okresního úřadu Třebíč Karel Müller [MASK] zastupitelstva považuje víceméně za huráakci .	postup
Poukazování na geografickou vzdálenost v tomto případě příliš [MASK] neuklidní , protože náš dovoz z ostatních států regionu ( Tchaj - wanu , Hongkongu , Jižní Koreje , Singapuru a Malajsie ) vzrostl v téže době o 30.5 % .	Číňany
Použijeme - li korektor v automatickém režimu , pak toto [MASK] použije jako náhradu .	slovo
Jak ale připomněl poslanec Michal Lobkowicz , ve světě tyto [MASK] z 99 procent financuje stát .	instituce
Parlamentní výbor pro sociální politiku a zdravotnictví , který včera s většinou zásad vyslovil souhlas , však [MASK] týkající se vzorového chování veřejně činných osob nepodpořil .	ustanovení
Na včerejší tiskové konferenci východočeského oblastního výboru ODA v Hradci Králové [MASK] řekl jeho předseda Václav Černý .	to
Nemilosrdné odhalování korupcí , politických čachrů a záhadných afér , které se denně valí z rotaček a televizních vln , tento [MASK] jen potvrzuje .	dojem
Protože nebylo dosaženo konsenzu , delegáti [MASK] rozdělili do informativních skupin , aby by jednali o dalším postupu .	se
Těm majitelům účtů , kteří tak neučiní , a tudíž jim poběží tříměsíční výpovědní lhůta ze strany banky , KB jejich [MASK] povede i nadále , ale od 1 . ledna 1995 jej již nebude úročit . o	účet
Protože kdo vyhlásí nižší cenu , [MASK] navštíví bandita a pohrozí mu něčím , když své ceny nevyrovná s okolními .	toho
Hospody ( je jich tu na sedm set ) [MASK] střídají s knihkupectvími .	se
Na Semináři na podporu vývozu českých strojírenských výrobků do Japonska [MASK] uvedl ředitel pražského zastoupení japonské organizace zahraničního obchodu JETRO Mitsuyoshi Saito .	to
Bývalý ředitel AGM i nadále jakoukoli [MASK] odmítá a tvrdí , že vše je pouze účetní nesrovnalost .	vinu
Prodloužení , i když v něm měli domácí 17 vteřin výhodu přesilové hry pět na tři , [MASK] už nepřineslo .	rozhodnutí
Vídeňský spisovatel Jakov Lind ( 1927 ) [MASK] dnes odpoledne ( v 16 hodin ) představí v pražské literární kavárně Viola .	se
Zástupce bruntálské pobočky Telecomu J . Strapáč [MASK] v Albrechticích nepopřel .	situaci
Sólistický soubor ovšem v současnosti mnoho výrazných [MASK] nemá a inscenaci proto jednoznačně dominovala herecky i pěvecky velmi dobrá , a navíc roztomilá Bystrouška Evy Dřízgové .	osobností
Palcové titulky na předních stránkách tisku [MASK] nesmyslně vraždícího útočníka s tichou podporou vyšetřovatelů identifikovaly : Agusta .	motivaci
Naprosto pirátsky , tedy způsobem zcela totožným s praktikami minulých i příštích zcizitelů ochranných známek , si [MASK] Charty 77 svévolně přisvojili .	jméno
Vedoucí představitelé strany podle něj tehdy tuto [MASK] odmítli .	možnost
Ministr spravedlnosti nedávno ve svém stanovisku [MASK] k silné soudní samosprávě jednoznačně odmítl , přičemž řekl , že jde o snahu pouze některých představitelů unie , ne - li jen jednoho .	tendenci
Zatímco poslanci koalice sdílejí názor Václava Klause , že růst hrubého domácího produktu ČR bude v příštím roce činit čtyři až pět procent , zástupci opozice [MASK] považují za přílišný optimismus .	to
Stihne - li parlament projednat a schválit devizový zákon ještě do prázdnin , pak ve druhé polovině roku běžného [MASK] bude zajímat asi pouze přetrvávající zákaz vedení peněžních prostředků - v české i cizí měně - na účtech v zahraničí .	smrtelníka
Např . i Čína , která byla v minulosti ve výrobě bavlny soběstačná , [MASK] dováží .	ji
Po jednání Asociace podnikatelů ČR a Ruské federace ČECHROS [MASK] řekl ruský obchodní zástupce Ernest E . Obminskij .	to
Jak vyplývá z údajů České národní banky , s výjimkou Egypta a Alžírska většina dlužníků vládní [MASK] , které byly sjednány v mnoha případech ještě předlistopadovými vládami , nesplácí .	úvěry
Podle informací LN česká , resp . československá federální vláda už od roku 1991 přímé vládní [MASK] neposkytuje .	úvěry
Po 154 dnech , které si kapitán v záloze Václav Klaus odsloužil na vojenských cvičeních , [MASK] včera náčelník generálního štábu Jiří Nekvasil povýšil na majora .	jej
Na včerejší tiskové konferenci klubu však nikdo tuto [MASK] otevřeně nevyslovil .	myšlenku
Tristní výsledky lyžařů v dosavadním průběhu sezóny [MASK] optimismu nedávají , nicméně odpovědní sportovní ředitelé jednotlivých úseků se přece jen nějaký pokusili vydolovat .	příliš
Brněnský prozaik a dramatik Jiří Kratochvil ( 1940 ) [MASK] v polistopadové době představil jako rozhlasový autor už několikrát ( Znáte to , Slepecké cvičení , Nahoru a dolů ) .	se
V titulní roli inscenace režiséra Milana Schejbala [MASK] představí Filip Blažek , známý filmovým a televizním divákům například z pohádky Nesmrtelná teta .	se
Práce umělců 70 . a 80 . let , např . J . Jemelky či M . Grygara , [MASK] uzavírají .	expozici
Když se opat oseckého kláštera dověděl , jaké problémy s nimi jsou , další [MASK] zakázal a němečtí hoši se museli i s vychovatelem z kláštera vystěhovat .	pobyt
Její zástupce ing . Šedivý však veškerou [MASK] za krizovou situaci odmítá .	odpovědnost
" Ne , já jsem tu [MASK] proti těm dětem nepodepsal .	petici
Z porušení příměří na sporném hraničním území , které bylo uzavřeno před šesti dny , [MASK] včera vzájemně obvinili představitelé Peru a Ekvádoru .	se
S odvoláním na bulharskou tiskovou agenturu BTA [MASK] včera ze Sofie oznámila agentura Reuter .	to
Průzkumy z hlediska politických stran žádný [MASK] přízně voličů ODS nenaznačují .	odliv
Zatímco ve prospěch zrušení se vyslovilo šest poslanců ODS , Jiří Vačkář , Jan Vraný , Pavel Šafařík ( všichni KDU - ČSL ) a Věnceslav Lukáš ( KDS ) [MASK] spolu s třemi zástupci opozice přehlasovali .	je
Od listopadového incidentu o poslanci Blažkovi nikdo z jeho stranických kolegů údajně [MASK] nevěděl .	nic
Správce a předseda správní rady této neziskové organizace Dalibor Černý by [MASK] použil na opravy libochovického a ploskovického zámku , umělecky významné kaple svatého Prokopa Charvátce , barokního špitálu v Lounech a zámku Peruce .	peníze
Dvě tiskové a tzv . billboardové [MASK] doporučila Arbitrážní komise Rady pro reklamu na stažení z veřejné prezentace .	reklamy
Jak vyplývá ze včerejší ankety LN , toto [MASK] přijímá i většina penzijních fondů .	řešení
K 1 . 1 . 1995 [MASK] PPF - První severočeský , První moravskoslezský , První jihočeský a První český investiční fond sloučily do Prvního českého IF .	se
Na semináři o problémech kapitálových trhů [MASK] oznámil ve čtvrtek Dušan Libnar z Ministerstva financí České republiky .	to
První větší hiphopový a rapový koncert v Praze v podání amerického diskžokeje Hurricanea , předkapely Luscious Jackson a hlavních hvězd večera , newyorských Beastie Boys , takřka šestitisícové [MASK] ve Sportovní hale rozhodně nezklamal .	publikum
Anebo přesněji , tabuizovaná a potlačovaná [MASK] pojí s intelektualizací a formální vytříbeností .	témata
Režisér a producent Jaroslav Soukup ( 1946 ) si filmařské [MASK] zkoušel od mládí při natáčení amatérských snímků .	řemeslo
Zatímco rčení mít smůlu bylo přijato do spisovného jazyka , [MASK] se slovem pech považujeme za nespisovnou .	variantu
Na srovnatelném místě už , doufejme , nikdo [MASK] podobného nepostaví .	nic
I když dávno překonalo dobu královny Viktorie , [MASK] historie si stále ponechává .	dotek
Jemná výšivka , pěna krajek a filigránský detail [MASK] jen potvrzují .	to
Nastupující generace už ve většině případů potetované [MASK] nepokládá za společenský handicap , ale výraz přesvědčení člověka , který se chce lišit .	tělo
V jedné ze svých přednášek jste českou [MASK] přirovnal k hemžení , které se objeví , když se odvalí kámen ležící nehnutě mnoho let na jednom místě .	společnost
Miloš Kirschner , šéf divadla , si nové [MASK] pochvaluje : " I přes ty starosti se stěhováním to stálo za to . "	působiště
Když to zjednoduším , my bychom [MASK] zkultivovali a oni by nám dodali voliče .	je
Výsledky přípravných utkání v průběhu zimní přestávky ( prohry s Neratovicemi , Baníkem Most i neúspěch na pražském Coca - Cola Cupu ) však k optimismu [MASK] nevybízejí .	příliš
Během Barákova působení ve funkci však StB [MASK] kontaktovala znovu a jeho spis byl archivován až v roce 1961 , v době , kdy se shodou okolností Barák se svým ministerským křeslem loučil .	Chalupu
Po nezdařeném osobním pokusu najít přechod ve Znojmě [MASK] v polovině dubna v Praze vyhledala Božena Dvořáková , zaměstnankyně ústředního sekretariátu a účastnice rodícího se odboje v národně socialistické mládeži , a sdělila mi , že budu převeden v noci z 15 . na 16 . duben 1948 a že mě převede Josef Damián , rovněž zaměstnanec ústředního sekretariátu .	mě
Pouze tam , kde se transsexuála přesvědčit nepodaří , [MASK] pohlaví zahájíme , protože určité tělesné poškození v jejím rámci je v těchto případech pro pacienta menším zlem než psychické následky spojené s životem v původní tělesné podobě .	přeměnu
Podle některých zdrojů čečenští obránci na jihu hlavního města již dlouho své [MASK] neudrží a budou muset také ustoupit .	pozice
Žádné převratné , neřku - li systémové [MASK] však Zemanova strana naštěstí nenavrhuje .	změny
Autoři dobrými úmysly motivované myšlenky centrálního plánování [MASK] tak vlastně začleňují do tábora těch politických stran , které příliš nedůvěřují tržním mechanismům .	se
Úmysl přizpůsobit naši subvenční politiku v zemědělství praktikám EU , což zcela logicky předpokládá zvýšení objemu státních dotací do této oblasti , [MASK] mezi státními příjmy a výdajovými možnostmi jen prohlubuje .	rozpor
Pokud panu premiérovi udělalo jmenování majorem dobře , tak mu [MASK] přeji .	to
Pro případ Lomova jmenování velvyslancem ČR ve Francii [MASK] včera s poukazem na volební klíč připomněl šéf klubu KDS M . Benda .	to
Prostřednictvím taxíkáře T . V . [MASK] seznámili s jeho družkou , bankovní úřednicí A . Z .	se
Podle údajů , které mají LN k dispozici , [MASK] osoby ručitele nepřijali někteří japonští institucionální investoři .	změnu
Jak dále řekl F . Tuhý , dobré obchodní [MASK] mezi OP Prostějov a jeho odběrateli narušují pohledávky po lhůtě splatnosti .	vztahy
Snad jedině rozumná dohoda , respektující fakt , že Chrám sv . Víta je objekt , postavený k bohoslužebným účelům , [MASK] o katedrálu vyřeší .	spor
Na slavnostním závěrečném shromáždění cvičících jednotek [MASK] včera ve výcvikové základně mírových sil OSN v Českém Krumlově uvedl ministr zahraničí Josef Zieleniec .	to
Právě severočeské mužstvo ( 7 . v tabulce ) [MASK] v pátek překvapivě namočilo do pásma nejistoty , když doma prohrálo 4 : 6 s Pardubicemi a bylo to již jeho třetí utkání v řadě , ve kterém vyšlo naprázdno .	se
Stejně jako poprvé , i nyní si autor [MASK] zařídil sám - od napsání a skládání přes aranžmá a rodinné nahrávání v soukromém studiu až po samotné vydání .	vše
V souvislosti s tím , že Portugalsko Českou republiku oficiálně ve snaze o vstup do aliance podporuje , LN tohoto [MASK] požádaly o rozhovor :	diplomata
Vědomé Havlovo hledání role intelektuála v prostoru poskytnutém rolí prezidenta a naplnění role prezidenta v prostoru role intelektuála [MASK] nejen nediskvalifikuje , ale naopak v obou rolích kvalifikuje v nejlepších demokratických tradicích .	jej
Žádná jiná transformující se země takovou kursovou [MASK] nemá , žádná země dnes nemá ten měnový kurs , se kterým svou složitou transformační operaci začínala .	stabilitu
Po skončení 1 . sjezdu strany [MASK] řekl jeho nově zvolený předseda Jaroslav Ortman .	to
V odpovědi na interpelaci Václava Grulicha ( ČSSD ) ve věci privatizace státního podniku Petrof Hradec Králové [MASK] uvedl předseda vlády Václav Klaus ( ODS ) .	to
Ještě že by to bylo jenom prvních čtrnáct dnů , [MASK] bychom snad unesli .	to
Na valné hromadě Sdružení podnikatelů okresu Uh . Hradiště [MASK] v sobotu uvedl předseda SP Rudolf Baránek .	to
Předseda okresního sdružení Miroslav Valenta jeho [MASK] podpořil a uvedl , že " pro hladký průběh podnikání potřebujeme sociální smír " .	názor
Jak sdělil spolupracovník svazu pro otázky ochrany prostředí Ivan Zíka , dobrovolný [MASK] RC vyhlásila mezinárodní organizace svazů chemie CEFIC v roce 1986 na základě zkušeností získaných od roku 1984 v Kanadě .	program
Podle prognózy Moravskoslezských tepláren , a . s . Ostrava , [MASK] ceny podstatně ovlivňuje hlavně nutnost vytvořit prostředky k úhradě investičních akcí , jež jsou nutné ke splnění ekologických zákonů .	tvorbu
Podle tiskové mluvčí českého ministerstva kultury Evy Rolečkové [MASK] příslušných smluv předloží slovenská strana do 15 . května .	návrh
O velkém politickém ohlasu těchto tezí [MASK] také nikdo neinformuje .	nás
Protože o nich on , jako specialista na Německo , [MASK] nepíše .	nic
I když v souvislosti s nedávno publikovanými výsledky průzkumu veřejného mínění občané tuto [MASK] příliš nedoceňují .	možnost
V Pistolnicích si čtyři padlé děvy svou [MASK] , práva i důstojnost už rezolutně obhajují samy .	čest
Na zaměstnanost mužů zóny moc velký [MASK] nemají .	vliv
Navíc , ačkoliv to může znít poněkud přemrštěně , asi bych skutečně originální [MASK] v žádosti o grant neuvedl nebo alespoň nesdělil otevřeně .	nápad
V rámci tzv . Mute Party [MASK] představí skupiny Miranda Sex Garden a Inspiral Carpets , které doplní osmadvacetiletý Newyorčan Richard Melville Hall - všem příznivcům taneční hudby známý jako Moby .	se
Lidé , kteří uzavřou smlouvu se zahraniční pojišťovnou , která nemá povolení u nás působit , [MASK] vystavují nebezpečí , že pojišťovna nedodrží podmínky smlouvy a že v případě jejího vypršení či takzvané pojistné události , kterou může být například úraz , nedostanou žádnou pojistnou náhradu .	se
Chystaná vyhláška ministerstev financí , která umožní zvyšování nájemného nad míru inflace , snad [MASK] bytů z regulovaného trhu do trhu bez státní regulace dostane .	část
BP sice nebude ve společném podniku [MASK] provozovat , ale všechny nově postavené budou odpovídat světovému standardu a budou nabízet širokou paletu služeb .	stanice
Vždyť , jak praví Zemanovo účetnictví , když by ji byl koupil , jistě by [MASK] zadlužil .	se
Podle informací dopravního inspektorátu hl . m . Prahy špatnou [MASK] zavinili především sami řidiči , protože se ve dvou užších pruzích báli jezdit a vytvořili tak jeden široký pruh uprostřed , ke všemu nevyužívali četných objízdných tras a zablokovali centrum .	situaci
Jak je vidět , McEnroe si z anglické tradice [MASK] nedělá .	nic
Budou - li však např . na sedm procent majetku zbývat dvě nebo tři procenta bodů a půjde o DIKy , jimž bude zbývat v knížkách po dvou či třech stovkách bodů , kupónovou [MASK] ukončíme .	privatizaci
Přízrak schodku , nezaplašený nějakým ústavním zákonem , by pak nutně [MASK] nutil aktivněji omezovat výdaje .	vládu
Ovšem některé rodiny často zrakově postiženého [MASK] obklopí a izolují .	člověka
Pokud amerického tenistu nepřejede auto , příštího US [MASK] se zúčastní	Open
Až dorazím do Tampy , do všeho [MASK] zasvětí Petr Klíma , který už tam měsíc je .	mne
Taková návštěva na přípravném utkání , kdy navíc hrozil pořádný liják , [MASK] zvlášť v Ostravě překvapila .	mě
Česko - německá komise historiků také rozumně tuto nemožnou [MASK] nepřijala a věnovala se své vlastní , potřebné práci .	roli
" Přestože naše výrobky jsou o něco dražší , zákazníci [MASK] vyzkoušeli a už se nechtějí k Induloně vracet . "	je
Ačkoli přiznání k dani z nemovitostí měla být odevzdána do 31 . ledna , občané [MASK] doručují Finančnímu úřadu v Táboře ještě v únoru .	je
Jak sdělila ředitelka táborského úřadu M . Syrová , pokutami zatím tyto [MASK] nepostihují .	občany
Novinář z americké stanice Christian Science Monitor Television [MASK] prý požádal pouze o několik záběrů práce bez zvukového záznamu .	je
Komise 17 . listopadu v čele se Stanislavem Devátým podle úředního záznamu [MASK] k dispozici neměla , a tudíž nemohlo dojít k vyzrazení státního tajemství .	svazek
Posun od figurální malby šedesátých let ke geometrismu a plošné barevnosti Načeradského [MASK] obohatil , jeho práce " zmalířštěly " .	tvorbu
Jako by mu to ukládal zákon " omert ? " , fundamentální norma mafiánské " kultury " , Andreotti [MASK] popírá : Nikdy neznal Ignazia Salva , ani jeho bratra Nina , nikdy se s Riinou nesetkal .	vše
Když by mohly , tak by [MASK] v době Marylin Monroe opět přihustily .	je
Lidé ukazující jednou rukou do budoucnosti nebo na nebesa , přičemž druhou sahají do vaší kapsy , [MASK] dělají podobně .	to
Na nedávné valné hromadě Českomoravského fotbalového svazu [MASK] zástupci nejslavnějších klubů málem pusinkovali u skleničky koňaku a vzápětí vyjma představitelů Unie majitelů fotbalových klubů vystřelili ruku nahoru pro zvolení staronového předsedy Chvalovského .	se
Český statistický úřad ( ČSÚ ) tyto [MASK] třídí a publikuje ve formě přehledů a tabulek .	informace
Návštěva v Hamburku , při níž Václav Klaus jednal s politickými a hospodářskými představiteli tohoto německého spolkového státu , zmíněnou dobrou [MASK] vztahů podle premiérových slov potvrzuje .	kvalitu
V letošním mistrovství Evropy jen tři [MASK] nevyhrálo porsche .	závody
Lidé , kteří se v něm točili , [MASK] teď realizují jinde , podnikají atd .	se
Okresní prokuratura ve Frýdku - Místku [MASK] viní z trestného činu podvodu .	je
Podle některých zpráv ukrajinská strana přesto [MASK] vozidel přes celnici částečně zdržuje .	přechod
Na základě informací z olomouckého arcibiskupství [MASK] včera sdělil náměstek primátora Olomouce Karel Šimša .	to
Protože dva ze tří převážených mercedesů jsou na rakouském seznamu kradených aut , řidiči [MASK] k nám zřejmě převáželi svým potenciálním zákazníkům .	je
Dokonce i svůj jediný veřejný politický [MASK] přednesl Clinton na legendární pláži Waikiki , kde mu naslouchalo několik tisíc lidí .	projev
Ještě před osmi lety jsme naše [MASK] prodávali v průměru za osm dolarů .	výrobky
Poté , co v Profitu č . 30 / 1993 vyšel článek o jejich činnosti , zhruba dvě [MASK] " zákazníků " BESO i SES tvoří čtenáři našeho časopisu .	třetiny
Objekt našeho čtenáře ani parametry ani polohou [MASK] optimismu při stanovení prodejní ceny nevyvolává .	příliš
Pro naše další úvahy budeme tedy [MASK] tis . Kč považovat za cenu , za niž by měl pan Kouba naději nemovitost prodat .	500
Jako dik bych v tom okamžiku , kdy se dozvím , že do firmy vstupuje cizí kapitál , a zajímal se jen o dividendy , takové [MASK] vůbec neobjednával .	akcie
Nápojové sklo vyráběné na automatických linkách takové [MASK] trhu nepociťuje , protože je levnější a jeho spotřeba není tolik ovlivňována konjunkturou .	výkyvy
Oficiální mluvčí bývalé sovětské tajné služby KGB , nového ministerstva i Ruské federální bezpečnostní agentury tyto [MASK] popřeli .	informace
S početním stavem si zde velkou [MASK] nedělají .	hlavu
Íránský chargé d ' affaires v Londýně G . Ansárí však [MASK] popřel a zdůraznil , že jeho země odsuzuje jakoukoli formu terorismu .	kontakty
Na otázku : Kam byste se zařadil na stupnici od jedné do sedmi , kde jednička znamená krajní levici a sedmička krajní pravici , [MASK] 41 procent dotazovaných situovalo od středu vpravo , 19 procent od středu vlevo , 29 procent zaujalo středovou pozici a 11 procent se nedokázalo rozhodnout .	se
Ústav sociální péče pro slepce Palata v Praze 5 by si podle slov ředitelky Kubíkové [MASK] v neziskovou organizaci velmi přál .	proměnu
Na rozdíl od slavnostního ovzduší , které panovalo v Jerichu loni na podzim při podpisu Deklarace o zásadách prozatímní autonomie , novou izraelsko - palestinskou [MASK] město oslavovalo střízlivě .	dohodu
Do chvíle rozhodnutí o udělení licence Český rozhlas [MASK] neinformoval o vyřešení své finanční situace , v tomto směru bylo informační vakuum i mezi stálou komisí pro sdělovací prostředky parlamentu a radou , přestože rada komisi průběžně informovala o stavu věci , o jednotlivých fázích a chronologii vývoje situace .	radu
Přitom by podle Kružici mnozí občané o takový postup [MASK] měli .	zájem
Úřad pro technickou normalizaci , metrologii a státní zkušebnictví [MASK] ČN 91 6010 pravděpodobně v nejbližších měsících vydá .	normu
Vyprávění o putování dvou motorkářů ( hráli je Dennis Hopper a Peter Fonda , v úloze jejich dočasného kumpána na sebe poprvé výrazně upozornil Jack Nicholson ) [MASK] zařadilo mezi kultovní díla své doby a stalo se jedním z generačních manifestů konce let šedesátých .	se
Čertovo kopýtko národnostních soudních okresů a národních kurií [MASK] ponechávalo ve střehu .	je
Pokud by měla na dodávkách zájem Tatra Kopřivnice , Siemens [MASK] uspokojí .	ji
Na setkání s představiteli zemědělských družstev a zemědělských obchodních společností [MASK] včera řekl premiér Václav Klaus .	to
V důsledku nižší kupní síly obyvatelstva pak naše podniky [MASK] své produkce vyvážejí a zboží se tam prodává pod cenou v důsledku nevýhodného směnného kursu .	většinu
Když to zjednoduším , my bychom [MASK] zkultivovali a oni by nám dodali voliče .	je
Jedenáct zápasů bez porážky , výborné výkony i zisk Superpoháru [MASK] v tom jen utvrzovaly .	je
Faktická volební porážka strany práce násobená nevybudovanou organizační strukturou a finančními problémy [MASK] odkazovala na okraj politické scény .	ji
Ačkoli se v petičním výboru , který je proti navrácení majetku Walderodemu , angažuje i řada členů současného turnovského městského zastupitelstva , představitelé města údajně jakoukoli [MASK] odmítají .	politizaci
Když si pohledná žena vybavuje krušné chvilky svého soužití s nemocí , [MASK] pod blonďatou parukou prořízne malá vráska .	čelo
Až Váš nástup do funkce ministra obrany ČSFR [MASK] přinutil reagovat na paradoxní situaci , kdy podle vojenské přísahy , a hlavně podle Vašich osobních rozkazů z roku 1985 jsem povinen pod Vaším velením se zbraní v ruce bránit světový komunismus .	mne
Již jednou jste mi její komunistický [MASK] připomínal , a protože Vás do Vaší nynější funkce navrhla protidemokratická strana , mám opodstatněné obavy , že by se situace mohla opakovat .	obsah
Když bych byl obklopen dobrými rockovými kapelami , tak by [MASK] to k nim víc táhlo , ale většina je jich amatérských .	mě
Také v tamním závodu a . s . Tabák svou [MASK] zvyšují .	výrobu
Jak známo , český sněm v úterý tento [MASK] schválil převážnou většinou hlasů ( 128 pro , 20 proti ) .	návrh
Oba vlivy - krajinný i společenský - [MASK] vzájemně prolínají a spolupůsobí dodnes .	se
Zatímco v tropickém podnebí Evropy bujely uhlotvorné pralesy , [MASK] pokrývaly pralesy mírného pásu .	Austrálii
Francouzské " procesy " s Martym a Tillonem [MASK] rychle přivedly k opouštění řad francouzských komunistů .	ho
Tato jeho poslední vášeň , konstruovat nové rychlejší přístroje na dešifrování lidských genů , [MASK] zcela zruinovala .	ho
Tito lidé , kteří takto vědomě vystoupili z jednotného šiku k jasným cílům pochodujícího lidstva , [MASK] neměli v životě lehké .	to
V západní Evropě a v USA farmáři [MASK] získávají jinak , prostřednictvím výkupních cen a bank .	dotace
Ani ODS , ani HZDS však [MASK] takového nepopírají .	nic
vždyť každý jiný národ si své [MASK] hýčká , pyšní se jimi , a český stát právě v současné době potřebuje sebevědomí dvojnásob .	osobnosti
Jedenadvacítka ihned zamířila autokarem do Jablonce , zatímco [MASK] van Himsta čekala jen pětikilometrová pouť do dejvického hotelu Praha .	svěřence
Na rozdíl od van Himsta trenér Máčala [MASK] úzkostlivě tají .	sestavu
Zatímco trenér Máčala sestavu tají , jeho protějšek van Himst [MASK] sype z rukávu	ji
Pokud o nich třeba nevěděl on osobně , na věci to [MASK] nemění , protože je odpovědný ČNR za činnost celé prokuratury .	nic
V minulém období pravice v ČNR [MASK] Ludvíka Brunnera neprosadila .	odvolání
Volili prakticky jen libanonští muslimové , zatímco křesťané [MASK] bojkotovali .	hlasování
Emocionálně a filozoficky zaměření komentátoři na obou březích Rýna takovou [MASK] doprovázejí aktuálním " vysvětlením " , že Francouzi prý dostali strach ze sjednoceného Německa , odkud se navíc objevují právě před referendem na titulních stránkách novin a v popředí televizního zpravodajství zprávy o řádění neonacistů .	úvahu
Vysoký představitel někdejší sovětské tajné služby však v rozhovoru pro ruskou televizi tuto [MASK] vyloučil .	možnost
Ministr si po těžkém otřesu mozku [MASK] nehody nepamatoval .	průběh
Přestože se zasedání zúčastnil i Rudolf Bereza , zastupitelstvo požadované [MASK] nedostalo .	informace
" I když samozřejmě vše záleží na počasí , průměrný klient [MASK] za osmadvacet dnů stihne .	to
Absolutní neochota mezinárodního společenství do vývoje zasáhnout a obnovit spravedlnost [MASK] však nakonec přinutí ustoupit .	ho
Pokud se takový scénář , dnes nejlepší z existujících špatných , naplní , budou [MASK] čekat nekonečné měsíce , a možná i roky vyjednávání a lokálních sporů .	Bosnu
Jestliže někdo nemá mít práci i po odstávce , ať se [MASK] dozví hned , ať dostane možnost odejít s pěti platy a hledat si jiné místo . "	to
Co se týče televizních licencí , Česká rada ovšem dosud [MASK] neudělila .	žádnou
- Ovšem při pondělním tréninku v Praze na Strahově jste na hlavě [MASK] neměl . . .	nic
Podle něj budou tyto tři strany svůj [MASK] průběžně konzultovat i s koalicí .	návrh
Už dnes , přestože návrh není zařazen na program schůze sněmoven , poslanci většiny parlamentních stran jeho [MASK] odmítají .	znění
Jak jsme se dále dozvěděli , všechny neprojednané [MASK] zákonů předchozí vlády Stráského kabinet z parlamentu stáhl a předkládá je jen tehdy , pokud si je osvojí ( nebo její člen ) .	návrhy
Němci , kteří byli v závěru války spatřeni při práci na mostě , [MASK] zřejmě umrtvili , aby by si zajistili z Tábora , kde bylo sídlo štábu gestapa , bezpečnou ústupovou cestu .	je
Jestliže si někdo myslí , že jsem byl povolán proto , aby bych obhajoval referendum vyhlašované FS , tak já si [MASK] nemyslím . "	to
S ostatními zeměmi bývalého SSSR zatím žádné [MASK] nemáme .	smlouvy
" Nejchudší " západoněmecký okres - pokud jde o úroveň příjmů - přesto zákonitě [MASK] železné opony uvítal .	pád
Těsný výsledek referenda však přesto jejich [MASK] upevnil .	pozice
Jenže vlastním významem oslněný český sněm tentokrát [MASK] rozumu nevyslyšel .	hlas
Vladimír Morávek a jeho stále " nedětštější " studio zatím novou [MASK] tají . . .	inscenaci
Firma Bona z Karviné k nám [MASK] produkované firmou Nuclear Blast Records , zaměřující se na death metal , nejen dováží , ale album skupiny INCUBUS BEYOND THE UNKNOWN dokonce vydala v licenci .	tituly
Dalšími akčními modely favoritů - vozy Favorit Prima , Forman Prima a Forman Excellent [MASK] na Motor Show prezentuje mladoboleslavská Škoda .	se
I přes tuto obhajobu prokurátor oba [MASK] žaloval z trestných činů loupeže , krádeže a porušování domovní svobody .	útočníky
Když půjde po servisu na síť , Connors [MASK] prohodí .	ji
Když hráč za mnou přijde , že ho bolí záda a že by potřeboval orazit , tak mu [MASK] věřím .	to
" Přestože jsme byli domluveni , že Martin bude minimálně rok v Kladně , aby by tady dostal šťávu , tak [MASK] pan Henyš zblbnul natolik , že odjel do Kanady .	ho
Jak budou budoucí generace toto rozdělení hodnotit , [MASK] nám ukáže až budoucnost .	to
Spíš by naopak naši zdramatizovanou politickou [MASK] ještě dál zdramatizoval .	scénu
Sympatie některých stran ke mně a odpor jiných stran [MASK] snad dostatečně potvrzují . "	to
Když bych byl při těch dávných Hovorech v Lánech , kdy mi to víceméně jen ' ujelo ' , tušil , co z toho vzejde , samozřejmě bych [MASK] neřekl .	to
Proti případnému jednání o navrácení Golanských výšin již však delší [MASK] protestují osadníci židovských vesnic rozmístěných na tomto území .	dobu
V prodejně potravin v obci Karlík nedaleko Prahy [MASK] vystřídalo už několik podnikatelů .	se
Vždyť správný muž na správném místě vynaložené [MASK] firmě svojí činností vrátí .	náklady
Zatímco rakouské hospodářství vesměs zažívalo recesi , poradenské firmy v oblasti personalistiky - Kopfjägern - [MASK] díky novým trhům nepocítily .	ji
V Atlantě na konferenci zahraničních zpravodajů , kterou pořádá americká televizní stanice CNN , [MASK] včera řekla americká velvyslankyně v OSN Madeleine Albrigtová .	to
Když by se ho naše teta nebála , určitě by [MASK] nekousnul !	ji
Sečteme - li výkony fotbalistů Sparty v obou zápasech předkola PMEZ proti IFK Göteborg , tak [MASK] do Ligy mistrů si Pražané opravdu nezasloužili .	postup
Jestli si potřebuješ zatelefonovat , tak [MASK] ještě udělej , za chvíli jsme v oblasti monopolu Telecomu . . .	to
Rozbor krize Apple a jejího postupného uzdravování , zajímavé postřehy o podnikové kultuře , metodách řízení a rozhodování tak rozdílných firem , jako jsou PepsiCo . a Apple , pak [MASK] zařadily mezi nejžádanější - ve všech amerických školách podnikatelského řízení je doporučována jako nejlepší praktická učebnice marketingu .	knihu
K prvnímu říjnu téhož roku mu Zemědělské družstvo Velké Přílepy [MASK] předalo a on spolu se svou manželkou začal hospodařit .	majetek
Ačkoli několikrát v životě doufal , že se do Tuchoměřic bude moci vrátit , po roce 1975 prý již [MASK] ztratil .	naději
Vzhledem k probíhajícím jednáním o vysílacím schématu na příští rok však [MASK] stanovený Febiem pro definitivní dohodu považuje za poněkud předčasný .	termín
Reakce některých politiků na novou iniciativu ODS V . [MASK] uspokojily .	Klause
Vzhledem k uvedeným potížím s uznáváním certifikátů a vzhledem k tomu , že dovozní přirážka má platit až do konce letošního roku , odborníci nějakou výraznou [MASK] v dosavadním vývoji obchodní bilance ČR a SR letos nepředpokládají .	změnu
Na včerejším jednání s českým ministrem průmyslu a obchodu Vladimírem Dlouhým [MASK] řekl ředitel agentury USAID pro střední a východní Evropu Tom Din .	to
Proto spolu s dalším místopředsedou ODS Zieleniecem tento [MASK] výkonné rady nepodpořil .	návrh
Mladý americký trumpetista Roy Hargrove takové [MASK] souvislostí obdivuhodně naplňuje .	vědomí
Pokud si je třikrát pozorně poslechnete , počtvrté [MASK] už pravděpodobně poznáte po hlasu .	je
Jestliže dnes za surové dříví z jednoho hektaru dospělého smrkového lesa může utržit asi 350 tisíc korun , zhruba [MASK] tisíc korun z toho musí vynaložit na založení , ošetřování a výchovu dalšího porostu .	140
Podle sdělení České pojišťovny naštěstí většina poškozených vlastníků uzavřenou [MASK] měla .	pojistku
Protože je však zřízení účtu ve středisku zdarma a zákon neobsahuje žádné sankce , mnozí občané dosud tuto [MASK] neuhradili .	částku
Na hraničním přechodu v Lanžhotě oba [MASK] včera převzali zlínští kriminalisté .	obviněné
Podle fotodokumentace , kterou nám půjčili policisté , jsme [MASK] po chvíli našli .	místo
Po včerejším jednání zástupců ministerstva kultury s firmou K . J . D . , která je výkonným provozovatelem České lotynky , [MASK] oznámil vedoucí ministrova sekretariátu Pavel Lagner .	to
Někdo [ byla to paní Olga Králová ] [MASK] dal dohromady v osmašedesátém ve Washingtonu , potom jsme si občas napsali , poslali pohlednici .	nás
Daniel Veselý z kanceláře prezidenta ČR , který donedávna působil na našem velvyslanectví ve Washingtonu a měl příležitost se s paní Albrightovou setkávat pracovně , [MASK] , zda někdo patří do akademického , či politického světa , ovšem odmítá :	posuzování
Předseda Českého svazu ledního hokeje Stanislav Burdys proto [MASK] jednou denně zval do asi dvacet kilometrů vzdáleného Pěnčína , kde má v pronájmu Kulturní dům .	mužstvo
V oblastních a místních sdruženích ODS , kde nemají potíže , si [MASK] jmenují sami .	zmocněnce
Avšak tam , kde existují znesvářené skupiny - například v Brně nebo v Opavě - [MASK] konkrétních zmocněnců doporučila výkonná rada ODS .	jména
Ačkoliv se mu tento požadavek téměř jistě nepodaří prosadit , naklíčené [MASK] nedůvěry ještě vydatně zalil .	semínko
Svůj rytmizovaný a zaujatý , výtvarný a básnický [MASK] vedou oba autoři na různá témata : vypočítávají varianty podob slasti tak , jak ji znají oni .	dialog
Ředitel peněžního odboru České národní banky Leopold Surga [MASK] považuje za absurdní .	to
Zatímco první doručovatelka před soudem řekla , že si není jistá , zda je pachatel , druhá [MASK] sice označila za pachatele , ale nikoli v souladu se zákonem .	ho
Průvodkyně Juliana Furaha ( Julinka Šťastná ) [MASK] rychle odvádí .	nás
Prezident Moi , který je u moci od roku 1978 po zemřelém Jomo Kenyattovi , někdejším představiteli národněosvobozeneckého hnutí , [MASK] však s demokracií nepřehání : nicméně v prosinci 1992 povolil pod tlakem opozice první pluralitní parlamentní a prezidentské volby po 26 letech .	to
Nakonec ale u jednoho salámovníku hoch náš [MASK] s úsměvem opouští .	busík
Co do tvaru a funkce jsem [MASK] přijímal jako sice náhradní , ale pravděpodobné vysvětlení , že člověk má duši podobnou jako štědrovečerní kapr .	ji
Nejvyšší rakouská místa , tedy úřady prezidenta , kancléře a vlády , konkrétní [MASK] oslav konce druhé světové války teprve zvažují .	úroveň
Některé dosavadní " kroky " výkonné moci na Slovensku zřejmě druhou nejsilnější [MASK] v SNR utvrdily v domněnce , že by bylo dobré zvýšit kontrolu vlády .	stranu
Slova Milana Ftáčnika , že pokud chce být parlament vládě partnerem , musí disponovat informacemi , rovněž [MASK] napovídají .	cosi
" Návrh zákona o způsobech zániku nijak [MASK] Slovenska vystoupit ze svazku neomezuje .	právo
Nejen poslanec Pavel Dostál ( ČSSD ) [MASK] označil za snahu zavřít novinářům ústa .	to
Naopak , někteří poslanci , například z HZDS či KDH , zmíněné [MASK] chápou jako ochranu osoby , která rozhovor poskytuje , v souladu s Listinou práv a svobod .	ustanovení
Fakt , že hrají " jen " studenti , [MASK] představení nikterak nesnižuje .	kvalitu
Profesor Svoboda , který právě působí v Itálii , nám v telefonickém rozhovoru svou pozitivní [MASK] potvrdil , řekl však , že nijak nesouvisí s jeho rezignací na funkci ředitele Laterny magiky ze dne 30 . května ;	lustraci
Když mi například kdosi z x - tého odboru ministerstva zahraničí pošle projev pro vystoupení v Budapešti , který je na computeru napsanou neutrální kašičkou , tak [MASK] prostě hodím do koše a přednášet ho nebudu .	ho
V éře Bubkových šestimetrových veleskoků by však ani dívčích 380 cm asi [MASK] neoslnilo .	nikoho
V případě , že do 31 . 12 . 1995 bude pokračovat v podnikatelské činnosti a vynaloží na rozvoj svého podnikání částku odložené daně , nebude [MASK] doplácet .	daň
Jak jsem se dověděl , pokud některý komponent krmiva tady podraží , výrobci [MASK] ihned nahrazují jiným při zachování nutriční hodnoty .	ho
A také zdaleka ne vše to , co se v Československu považuje za bohatství , se jako [MASK] jeví lidem v zahraničí .	bohatství
Ti , kdo jsou vyděšeni z nadcházejících změn ve zdravotnictví , [MASK] vidí černě a lekají se jejich zběsilého úprku , ti nedočkaví soudí , že reforma se vleče příliš pomalu .	je
Armády bývalé Jemenské arabské republiky ( na severu ) a bývalé Jemenské lidové demokratické republiky ( na jihu ) [MASK] po sjednocení obou zemí v roce 1990 dosud nespojily .	se
Mezi první a druhou světovou válkou [MASK] ve stejném křesle vystřídalo patnáct mužů a průměrná doba ve funkci činila tehdy 1.4 roku .	se
Když americké velení protestovalo , de Gaulle prostě [MASK] vyňal z pravomoci amerického velení .	divizi
To , že by vláda měla sama vydávat akty se silou zákona , [MASK] šokuje .	ji
Od roku 1918 prý u nás vláda [MASK] s váhou zákona nikdy nepřijímala .	opatření
Demokratické státy spolu , jak známo , [MASK] nevedou nebo téměř nevedou .	války
Jinak než po způsobu truchlohry " O hodném Škrholovi a zlém Konijášovi " [MASK] zatím neumíme a hned tak umět nebudeme .	to
Jak uvedla tisková mluvčí královéhradeckého magistrátu Jitka Prokšíková , [MASK] podepsali hlavně občané , kteří v Hradci Králové nežijí .	petici
Po sobotním návratu české parlamentní delegace z USA [MASK] prohlásil předseda Poslanecké sněmovny Milan Uhde ( ODS ) .	to
Vítěz prvního ročníku Jindřišských knedlíků - 230 kilogramů vážící hostinský z Raduňky , [MASK] spořádal za patnáct minut dvacet čtyři .	jich
Podle osvědčeného modelu z MS ve Spojených státech a v souhlasu s vyhláškou UEFA [MASK] schválila na svém jabloneckém jednání ligová komise ČMFS .	to
Stejný únorový průzkum jiné agentury - Střediska empirických výzkumů ( STEM ) - tento [MASK] nezachytil .	trend
Ten si však ani na tuto rozhodující schůzku [MASK] neudělal .	čas
Co si autoři vymyslí - a jsou to zhusta jaksepatří krkolomné kousky - [MASK] náležitou formou zobrazí .	to
Pokud má nějaký problém , tak [MASK] z velice vyrovnaného kádru postavit do základní sestavy .	koho
Hráči licitovali , neustále si kladli nové požadavky , a my [MASK] plnili .	je
Např . pro n = 33 čísla psaná v jiné soustavě přepíšeme do soustavy třiatřicítkové ; nebo [MASK] očíslujeme jejich pořadím v abecedě ; atd . )	písmena
Ačkoli sodíková vrstva byla objevena před více než 60 lety , většina geofyziků [MASK] pokládala spíše za kuriozitu , pokud vůbec si jsou vědomi její existence .	ji
W . S . Boecker z Lamontovy - Dohertyho geologické observatoře v Palisadě ( v USA ) tuto [MASK] komentuje slovy : " Jsem zmaten .	situaci
Uděláme - li to vhodným způsobem , pak nejen [MASK] neztratíme ( mikrostavy stejně nikdy nikdo nevidí ) , ale získáme v mnohém dokonce i lepší porozumění skutečnosti .	nic
Jurij Smirnov , který spolupracoval s A . Sacharovem na pumě , Charitonovovu [MASK] doplňuje : Sovětská špionáž umožnila zásadně zkrátit vývoj atomové pumy .	výpověď
Složením této rychlosti s původní rychlostí v planetka posléze [MASK] mine .	Zemi
Uvědomíme - li si některé bezprostřední důsledky právě dokázaného tvrzení , rázem [MASK] zařadíme mezi nejpodivnější z těch , které jsme až dosud o našem odsouzeném geometrickém světě dokázali .	je
Poměrně jednoduchá tvrzení 4 a 5 tuto [MASK] již navozují .	korespondenci
Odkrytím omylu v předcházející úvaze - a v řadě úvah podobných - [MASK] postupně utvrdíme v přesvědčení , že takovéto " zmenšování " parametru není schůdnou cestou k jeho popření .	se
Nebezpečí , že bychom mohli shora uvedeným způsobem rozbít klasický geometrický svět , [MASK] vede k úvahám o tom , zda zjištění , že v reálném světě není součet úhlů v trojúhelníku roven dvěma úhlům pravým , by vskutku mělo za následek zkázu klasického geometrického světa .	nás
2 ) Od 1 . dubna nebude ÚNMS SR [MASK] české zkušebny potvrzovat .	rozhodnutí
Narovnávání cenových deformací a dokončování deregulace cen bude však [MASK] inflace ještě jistou dobu brzdit .	snižování
Když najdete takové lidi , budete [MASK] střežit jako oko v hlavě .	je
A většinou též vyšší - vždyť proč bychom [MASK] zbytečně podceňovali !	se
* Pokud je tady riziko chybného rozhodnutí extrémní , proč vládní [MASK] nesoustředit třeba do průřezových ekonomických činností ?	podporu
Od té doby již žádnou tak velkou [MASK] neměla , přesto mezi prodejci počítačů Macintosh zaujímá pravidelně jedno z prvních míst .	zakázku
Pokud nebyly všechny k dispozici , některé [MASK] vytvořila Giga sama , anebo podnítila jejich vývoj u jiných firem .	programy
Proto nyní kanadské pošty každou nahlášenou [MASK] minimálně jednou prověřují .	změnu
Na bankovním a finančním veletrhu Fibex 94 [MASK] uvedl Vladislav Pavlát , předseda výboru pro burzovní obchody .	to
Třebaže , sám o sobě , jim žádný mimořádný [MASK] nepřinese .	profit
Již dříve vládou vyhlášený Program rozvoje cestovního ruchu uvedené [MASK] zdaleka nevyřeší .	problémy
Přes problémy , které letošní zima přinesla , [MASK] mají Kanaďané rádi .	ji
Ruský velvyslanec v Egyptě Vladimir Poljakov ve čtvrtek [MASK] i datum konání potvrdil .	místo
Z rozhovoru se ovšem návštěva o nejhlubších pocitech dětí [MASK] nedozvídá .	mnoho
Dva metry vysoký a 126 vážící obr tento [MASK] získal i v letech 1986 a 1987 .	titul
Vzhledem k poklesu poptávky na tuzemském trhu [MASK] závod orientoval více na export .	se
Nebývalý růst poptávky po prezervativech , které každoročně v rámci své pomoci rozděluje Americká agentura pro rozvoj do zemí třetího světa , její [MASK] nemálo překvapil .	činitele
Podle údajů této odborové ústředny sedmé velmoci si letos největší [MASK] vybrala válkou zmítaná Jugoslávie , kde bylo zabito 21 novinářů , a Japonsko , kde 15 reportérů zahynulo při zajišťování zpravodajství o nečekané erupci sopky Unzen .	daň
Tvrdý a tvrdě uplatňovaný zákaz vycházení [MASK] završil a v Phnom Penhu zavládl nejistý klid .	vše
Ačkoli bylo prakticky celé premiérové obsazení vídeňské provenience , představitelky ženských postav [MASK] zpočátku " hledaly " - teprve postupně se S . Markovichová ( Rosalinda ) a M . Cerno ( Adéla ) rozezpívaly ke skutečně brilantním výkonům .	se
J . Němec a E . Krumbachová [MASK] přijali podle vlastních slov " v hodině dvanácté " , pouhý rok před světovou premiérou v Pompejích .	práci
Ale co když bychom , třeba také jen na zkoušku , tohle [MASK] a mnohé jiné přijali jako nevyhnutelný důsledek půlstoleté zkázy na nás ( ale také námi ) uvalené , na mříže nesvobody , za nimiž jsme byli zavřeni a s námi prakticky všechny hodnoty a dobroty běžné i jen v méně postižených společenstvích ?	všechno
Sdělení , že třetina poslanců má ještě další zaměstnání , [MASK] zarazilo ne proto , že bych jim nepřála vysoké příjmy , ale že si myslím , že činnost v FS by je měla všechny zaměstnávat měrou vrchovatou .	mě
Co ale těmto " špičkovým přípravkům " říká náš zákon o ekologii , [MASK] už se divák z reklamy samozřejmě nedozví .	to
Navíc ve chvíli , kdy by stát skutečně přestal přispívat politickým stranám , automaticky by [MASK] zbavil možnosti kontrolovat jejich hospodaření .	se
Rakušané , kteří měli původně v úmyslu zabývat se dostavbou odpovídající komunikace až v pozdější době , [MASK] přizpůsobili české straně .	se
Benzina , a . s . současné [MASK] pohonných hmot od 1 . května měnit nebude .	ceny
Rozhodnutí ligové komise ČMFS hodnotit od příštího ročníku 1 . a 2 . ligy vítězství třemi body [MASK] inspirovalo k malé historické sondě .	nás
Jak uvedl její předseda Jaroslav Vlček , zelení [MASK] ani v současnosti nepovažují za opozici .	se
V dubnu 1948 StB Z . [MASK] zatkla a obvinila z velezrady .	Tomana
Po zakončení výjezdního zasedání meziparlamentního výboru Evropského parlamentu v Praze [MASK] včera uvedl jeho předseda Vittorino Colombo .	to
Předseda Liberální strany národně sociální si [MASK] činovníků na komunální úrovni vysvětluje špatným zákonem o obcích , který jim nedává dostatek pravomocí k samostatnému hospodaření a rozhodování .	rozladění
Ve včerejším vydání listu Die Presse ministr svůj původní [MASK] opravil : " Když by neutralita jednou skutečně měla být odstraněna , je to věc parlamentu , a nikoli referenda . "	výrok
Německá spolková republika dosud v četných případech politických uprchlíků , kteří se stali německými státními příslušníky , dvojí [MASK] tolerovala a ještě toleruje .	občanství
Na to , co chci iniciovat , vlastní [MASK] nepotřebuji .	prostředky
Letos při jeho 50 . výročí [MASK] Slovenská republika vyhlásila zákonem za státní svátek .	ho
Když by pan ministr Dlouhý nás informoval , že je v něčem rozpor , určitě bychom [MASK] nepokládali za nevzdělance .	ho
Festivaloví hosté , kterých je půldruhé stovky , velký [MASK] o sedmi stech místech nezaplní .	sál
Z úvodní zdrcující porážky od Ruska 3 : 12 si [MASK] nedělal : " Přijeli jsme se učit , získat zkušenosti a ty pak využít proti slabším soupeřům a zachránit se , " uvedl na tiskové konferenci .	nic
V Německu , ve Francii a v Itálii toto [MASK] kostelů i výsostné právo katolické a evangelické církve uvnitř chrámu v uplynulých letech demonstrovali věřící třeba tím , že se do kostelů uchýlili se žadateli o asyl , kterým hrozilo vypovězení .	vlastnictví
Když by skupina lidí v západní Evropě , kde od Itálie až po Irsko existuje několik desítek starších , historicky a uměleckou výzdobou významnějších katedrál , dómů a chrámů , než je sv . Vít , vyslovila požadavek na znárodnění dejme tomu katedrály San Giovanni in Laterano v Římě , od roku 324 , třináct století před sv . Petrem ve Vatikánu chrám papežů , dómu v Řezně , kde v roce 834 bylo pokřtěno 14 českých knížat , když by někdo chtěl znárodnit španělský Escorial , vídeňského sv . Štěpána , dóm sv . Marka v Benátkách , mešitu Hagia Sofia v Cařihradu , synagogu v Toledu , dóm ve Frankfurtu , Notre Dame v Paříži atd . atd . , tak bychom [MASK] považovali za lidi , v nichž evropské dějiny zanechaly stopy barbarských vpádů do duší a jizvy primitivního ateismu .	je
V parlamentu , který tento týden zasedá před červnovými volbami naposled , poslanci tento [MASK] diskutují již třetím dnem .	problém
Dosavadní zákon o jménu a příjmení , přijatý za Mečiarovy vlády , tyto [MASK] plně neuspokojil .	požadavky
Její ministři , např . ministr Kočárník a ministr Lux , ale i jiní , [MASK] podporují .	mne
Pokud se místní organizace rozhodne pro spojenectví se sociálními demokraty , centrum nebude [MASK] namítat .	nic
Jeden téměř dva metry vysoký náhrobní [MASK] pachatelé zcela zničili .	kámen
Kdo se ztratil v ohledech k druhým , nikdy [MASK] jako člověk nenalezl .	se
V překladu Svatopluka Horečky a s doslovem Jiřího Pelána její třetí české [MASK] připravila pro svou Malou řadu Mladá fronta .	vydání
Podle M . J . Švejdy si Jan Grossman Bennettovu [MASK] " vybral ne zcela z vlastní vůle " , ba dokonce " nedobrovolně " , její inscenace se stala " jen další zákrutou v Grossmanově životě " a " byl navíc kvůli ní nucen odložit svůj dlouho chystaný projekt " ( Kupce benátského ) .	hru
To , že v dvacátém se zhroutilo mnohé z toho , čím žila století předcházející , a zejména devatenácté , [MASK] neříká o tom , které z minulých otázek ožijí nebo neožijí v příštím čase .	nic
Na rozdíl od prezidentského kandidáta , který musí být zvolen , [MASK] na úřad viceprezidenta si vybírá samotný uchazeč o prezidentství - ovšemže pod dozorem stranických vůdců .	kandidáta
Jeho sen dostat se do Guinnessovy knihy rekordů [MASK] stál pět let práce a 12 miliónů tchajwanských dolarů .	ho
Občan , který není ochoten chodit platit nájemné či poplatky za telefon na poštu , velký [MASK] rozhodně nemá .	výběr
Protože se podle policistů Wonka trestnímu stíhání vyhýbal , policie [MASK] v pondělí zadržela a okresní soud v Semilech na něj uvalil vazbu .	ho
Podle informací ministerstva práce a sociálních věcí sporné [MASK] ze Žďárska v těchto dnech posuzuje skupina odborníků .	případy
Předseda komise Vlastimil Doubrava ( nezařazen ) však po jejich odchodu [MASK] přerušil , takže hlasovat se bude stejně až dnes .	schůzi
Kapitán mužstva Anglie David Platt , který se marně pokoušel chuligány uklidnit a jen se štěstím unikl zranění , [MASK] komentoval : " Jsem ohromen .	incident
Druhá část výstavy , ukazující práce Wagnerových českých žáků a podaná v původních výkresech a modelech , tuto [MASK] jen potvrzuje .	zkušenost
Po Drvotově tragické smrti v roce 1987 však dobré časy [MASK] opouštěly .	Babalet
V rozhovoru pro včerejší vídeňský deník Kurier [MASK] prohlásil ministr obrany Werner Fasslabend z Rakouské lidové strany .	to
Rada v novém složení však svou [MASK] filtru proti neúměrné konkurenci již přijala zjevně .	roli
Jak jsme již podrobněji informovali ve včerejších LN , [MASK] Vopálenské údajně objednal její obchodní partner Rudolf Korbel .	vraždu
Na pražském semináři pořádaném Středoevropskou univerzitou a Českou křesťanskou akademií [MASK] prohlásil Josef Alan z Institutu sociologických studií .	to
V souvislosti se soudním sporem o vlastnictví a správu katedrály [MASK] v Praze zjišťovala společnost Dema .	to
Reakce Rakouska - Uherska na ultramontánní projevy Pia IX . a I . vatikánského koncilu tento [MASK] dále urychlila .	vývoj
Pokud někoho napadne například souvislost holubovská , ať [MASK] hned zapomene : Zogatova " laboratoř " nezná povlovnou analytičnost směřující k " modelové " pointě .	ji
Nakladatelství Franze Kafky , které ji vydává v řadě Poláčkových spisů v maximální možné úplnosti , [MASK] doplnilo o torzo zamýšleného pátého dílu ( kapitoly 5 - 16 ) , který měl tvůrce předat přátelům před transportem .	opus
Jak již řečeno , měřítkem správnosti tu [MASK] nepořídíme , neboť přinejmenším psychologicky jsou v tomto případě chůze i postávání stejně únavné .	mnoho
V reakci na spekulace některých sdělovacích prostředků [MASK] včera uvedl předseda ČMKOS Richard Falbr .	to
Někteří její představitelé - jako pan Zieleniec - [MASK] chápou a snaží se prosadit program jiný .	to
Podle jedné z nich , Tamary Starnovské z pražské vinohradské nemocnice , však nemocní například [MASK] odmítají .	sóju
Na setkání vedoucích pracovníků firem , které se na jeho výstavbě podílejí , se členy městské rady [MASK] uvedl ředitel společnosti Inženýring dopravních staveb Bohumil Kvasnička .	to
Ostatně , provedená valorizace důchodů k 1 . prosinci 1994 a již vládou schválená valorizace k 1 . červenci 1995 tento [MASK] všem , kdo to slyšet chtějí , potvrzují .	závazek
Výzkumný ústav práce a sociálních věcí nyní jejich [MASK] vyhodnotil a při hledání odpovědi na otázku , jak vlastně vypadá a žije česká rodina , došel k zajímavým závěrům .	výsledky
Rodina tedy v prvních pěti letech transformace společnosti zvláštní [MASK] nezaznamenala a naopak , jak tvrdí odborníci , vnější ekonomický tlak by ji měl v budoucnu dokonce stmelit .	krizi
Vzniklá tvrdá konkurence komerčních televizí by navíc také [MASK] přinutila hledět i na zájmy menšinového publika .	je
Policisté po příjezdu na místo činu [MASK] zadrželi a zatím je obviněna z trestného činu ublížení na zdraví s následkem smrti .	ženu
Proti adresnosti většiny z devíti dávek , které obsahuje vládní návrh zákona o sociální podpoře , představitelé rozhodujících politických stran [MASK] nenamítají .	nic
V odpovědi na interpelaci předsedy Strany zelených , poslance Jaroslava Vlčka [MASK] uvedl ministr životního prostředí František Benda ( KDS ) .	to
Demonstranti , kteří nesli na kůlech kožešiny potřísněné symbolickou krví a rozdávali letáky s hesly odrazujícími od zabíjení zvířat , po dvou hodinách v klidu [MASK] ukončili .	protest
Digitální hodiny na přístrojové desce a druhé při vypnutém rádiu mi [MASK] nenahradily .	ho
Benešovský fotbalový klub si dosud nového hlavního [MASK] nenašel	sponzora
Sám Švarc už do fotbalu žádné [MASK] nedává , shání však - zatím bez úspěchu - jiného hlavního sponzora .	peníze
Moravané si však vedle svých mladíků [MASK] slibují od levonohého Vítka , jehož si trenér Adamec vyhlédl v Žilině .	hodně
Klíčový hráč St . Louis Blues a jeho třetí nejlepší střelec v posledních dvou sezónách Craig Janney s největší pravděpodobností [MASK] opustí .	celek
Nejproduktivnější hráč NHL Jaromír Jágr ( Pittsburgh ) v neděli nejlepšího [MASK] soutěže Dominika Haška ( Buffalo ) nepřekonal	brankáře
" Pokud s tím nezačnou něco dělat , nynější smlouvy [MASK] zahubí .	je
Věren tradicím našeho trenéra Beránka však nebudu [MASK] jmenovat .	nikoho
Například v TV Nova i na ČT 1 několik mladých redaktorů podobné [MASK] soustavně zpracovává .	případy
Krátce po mém nástupu do Hosta [MASK] oslovili ze Svobodné Evropy , takže se mi teď na stará kolena splnil můj dávný sen .	mě
Osvobozené myšlení bez opory , zejména myšlení intelektuálů v politice , nám právě [MASK] takového v uplynulých letech předvádělo .	cosi
Devět kandidátů na prezidenta USA z Republikánské strany [MASK] v neděli představilo předním členům strany ve městě Manchester ve státě New Hampshire , a fakticky tak zahájilo kampaň před volbami 1996 .	se
Po jednání s čadským prezidentem Idrissem Débym [MASK] včera oznámil francouzský ministr pro spolupráci Bernard Debré .	to
Jak parlamentní , tak vládní komise [MASK] ODA vůči BIS odmítly a není na nich , ale pouze na samotné ODA , jak se s celým případem vnitřně vypořádá .	obvinění
V odpovědi na interpelaci poslance Františka Kačenky ( ČMUS ) [MASK] připustil premiér Václav Klaus .	to
Zatímco reprezentanti tohoto orgánu se domnívají , že by ČKR měla být zmíněna v zákoně jako vysokoškolská samospráva , a tudíž i oficiální partner pro různá jednání , premiér si [MASK] zjevně nemyslí .	to
Lidová hra Saracénský čert aneb Husité před Plzní , kterou chce ochotnická společnost Žumbera uvést na plzeňském náměstí k 700 . výročí založení města , podle vyjádření biskupa Františka Radkovského a dalších zástupců církví a řádů plzeňskou [MASK] uráží .	ekumenu
Před jednou z nich - tou západní - [MASK] právě Zdeněk Mlynář varuje .	nás
