Canı , cananı bütün varımı alsın da Hüda / [MASK] tek vatanımdan beni dünyada cüda	Etmesin
Bir kez böyle bir tesadüf gerçekleştikten sonra , çarpuk çurpuk aynalarla dolu bir salonda [MASK] kendimi .	buluverdim
Sonra sen gazetende istediğin gibi [MASK] dumanı .	ver
Azgın dalgalar saman çöpü gibi [MASK] salın hezenlerini .	dağıtır
Alkol , tütün ve aşk [MASK] beni .	eskitti
Gene de her ikimiz de inatla [MASK] kendi aldatmacamıza .	sarıldık
Kerem et aklından [MASK] beni / Ağla , gözyaşını sil melul melul	çıkarma
Ömrünü bu umuda kerterizlemiş kadınlar ordusunun bir neferi olarak [MASK] kendini .	görüyordu
Bir gece yanında mihman olduğum / Sabah oldu deyi [MASK] beni	kaldırdın
Tepti yeri , var gücüyle palet vurarak yükseldi , [MASK] başını .	kaldırdı
O döner dönmez bir punduna getirip [MASK] sizi .	tanıştırayım
Zeynep , bir şaplak [MASK] önündeki kil hamuruna ve güldü .	indirdi
Gönlüme teselli kendimde buldum / Sabır ile teskin [MASK] özümü	ettim
Merak bu ya , bir gün uzaktan [MASK] bizim takımı .	seyredeceğim
Kanun yoluyla faizcilik yapan bankalar [MASK] iki yanı .	tutmuştur
10 PUAN ÇOK MEMNUN [MASK] HER ŞEYDEN .	KALDIK
GENEL OLARAK MEMNUN [MASK] TESİSTEN .	KALMADIM
Bacağını pamukla alkolledikten sonra [MASK] iğneyi .	dayandı
Sanki yarım ağız söylediğimi anlamış gibi bıyık altından gülerek şöyle bir [MASK] beni .	süzüyor
Ne olur bir biçimine getir / [MASK] şu linyiti çıtır çıtır	yak
Bir nevi oyunbozanlık da [MASK] bunu .	sayabilirsiniz
Bir yudum anlayış görebilmek için yüzünde , [MASK] kendimi .	zorluyorum
Arkasında birileri var gibi , basından birileri sanırım , sürekli [MASK] herifi .	fiştekliyorlar
Geceden hazırladığım poşeti alıp ses çıkarmamaya gayret ederek [MASK] katları .	indim
Yolcu taşıyan bir halk otobüsü , yanmış benzine ve yağa [MASK] ortalığı .	buladı
Gelinin babası insaflı çıktı da [MASK] Gülizar'ı bizim oğlana .	verdi
Azabın , biliyorum , ölümden daha derin / Baba , isyan [MASK] gökyüzüne kederin	etmesin
Düşünen filozof yeryüzü yaşamasına sımsıkı bağlı bu maddeci görüşten [MASK] kendini .	sıyıramıyor
Kuyruğum sıkıştı mı , [MASK] Aysel , gelsin Ömer !	gelsin
Bizimkilerin de amacı aynı / Doğan güneşle birlikte kökünüzü kazıyıp / Yeryüzünde [MASK] izinizi	bırakmamak
Nasıl sevebilirse üç gönül bir tek gülü / Sen de güzelliğine kul [MASK] üç gönlü	edersin
Öbür seferler arkasında Servet Bey vardı ; bir kulpunu bulur , [MASK] mühletleri .	uzattırıverirdi
Güneş yakmasın diye onun güzel başını / [MASK] siper olurken iki arkadaşını	Gördüm
Sen gittin soframız [MASK] tarumar .	oldu
Sonra köy ağası hazretleri bizim de kıçımıza [MASK] tekmeyi .	atacak
Babam senden çok mu [MASK] kalını ?	istedi
Ak pak gerdanı , bileziklerle dolu kolları ile [MASK] Fahriye ablayı .	görürüz
Karşı dağlarda tutuşmuş gibi gül bahçeleri / Koyu bir kırmızılık gökten [MASK] yeri	ayırmada
Kapının sarı tokmağını avuçlayıp çeviriyor , kolaycacık [MASK] kapı .	açılıyor
Babama olan bağlılığımdan ziyade , anneme duyduğum kızgınlıktan [MASK] bunu .	yaptım
Yüzleri , kafalarından aşağı birkaç bakraç su akıtılmış gibi [MASK] terden .	sırılsıklamdı
Baloz merdiveninden çıkar gibi [MASK] ki gemi merdiveninden !	çıkılmaz
Oldukça başarılı bir [MASK] , notları ortalamanın üstünde .	öğrenciymiş
Ne saklayayım gaflet ettiğimi / Elimle [MASK] gençliğimi	batırmışım
Geçtik hepimiz dörtnala cennet kapısından / [MASK] ebedî ; cetleri bir anda yakından !	Gördük
Yetişir koştuğum aşkın peşi sıra / [MASK] beni bu içki , bu kumar	Bitirdi
Ama işin aslını öğrenince güldü , [MASK] anacığının buruşuk yanaklarını .	okşadı
Bir elinde cımbız , bir elinde ayna / [MASK] mı dünya ?	Umurunda
Gerçekten de çökkün , üzgün ve zavallı [MASK] onu .	bulmuştu
Çok aradım bulamadım dengimi / Elvan çiçeklerden [MASK] rengimi	aldım
Ala gözlü nazlı dilber / [MASK] beni el yerine	Koma
Eli kulağında , ya bugün [MASK] kapıyı ya yarın çalar .	çalar
O gün çözer gibi [MASK] Kütahya çinilerindeki dipdiri renklerin gizini .	olmuştu
Ama üstüme düşüldü mü [MASK] bir gönül tokluğu , bir nazlanma , bir ağırdan alış .	bende
Hancı , dedim , [MASK] mi Maraşlı Şeyhoğlu'nu ?	bildin
Yumuşak ve içten [MASK] konuşmasını .	sürdürdü
Aldım Rakofça kırlarının hür havasını / [MASK] akıncı cetlerimin ihtirasını	Duydum
Sen ilk aşkım , ilk göz ağrımsın / Dünyalara [MASK] seni	değişmem
Gemi baş döndüren zaferli bir gürültüyle [MASK] sulara .	indi
İnsan sarrafı olacaksın , [MASK] adamına göre iş yapmasını , laf etmesini !	bileceksin
Ben kırkyıllık inşaatçıyım , [MASK] hepsini .	tanırım
Sana yalan söylemişler , dalga geçmişler , [MASK] seni .	işletmişler
Bir kere gözlerime baksanız [MASK] / Sizin için kalbimde canlanan emelleri	anlardınız
Kimisi ( kim - i - si ) , [MASK] ( hep - i - si ) .	hepsi
Paris gibi bir kentte , bu hatırlamalar , karamsarlığa [MASK] insanı .	sürükler
Bekçisi kalsın artık bu yurdun ihtiyarlar / Koç yiğitler [MASK] başka güzel diyarlar	arasın
Top gürleyip oruç bozulan lahzadan beri / Bir nurlu neşe [MASK] kerpiçten evleri	kapladı
Sonra bir el [MASK] gemiyi tezgâhtan ayıracak levyeyi .	çekti
Çoğunlukla akşam yemeğinden sonra , sofra kaldırılınca yemek masasında [MASK] o öyküleri .	yazardım
Gülmek istedim , [MASK] bir memleket havası .	tutturdum
Kanatları kurşunla parçalanmış bir kartal / Benim gibi [MASK] , yerden , mavilikleri	seyreder
Bir denklemde küçük bir eksi artı yanlışı altüst [MASK] eşitliği .	eder
Nasıl sevebilirse üç gönül bir tek gülü / Sen de güzelliğine kul [MASK] üç gönlü	edersin
Bir oylamada hakkım olan bir oyu bile bile esirgemiş , [MASK] beni .	kırmıştı
Bu sebepten , sanki daha önce hiç temizlenmemişçesine [MASK] evlerini .	temizlerler
Dinledim sokaktaki ayak patırtısını / [MASK] iki kişinin para lakırtısını	Duydum
Büyük Itri'ye eskiler [MASK] / Bizim öz musikimizin piri	derler
Çocukluğunda çoğu ramazan akşamları bu pencerenin önünde [MASK] iftar topunun ışığını .	beklerdi
Allah , ince ruhlu kibar [MASK] bu kızı .	yaratmıştı
Sanat adına konuşmakta kendinde hak gören , her konuştuğunu da salt doğrudur diye karşısındakine kabullendirmek isteyen kimseler [MASK] etrafımızı .	sardı
Sandukanın yeşil çuhasına başını dayadığında , sanki bir el saçlarını okşayıp teskin [MASK] onu .	edecekti
Sarıldığı gibi iki yanağından içtenlikle [MASK] müdürü .	öpmüştü
Kültür düşüklüğündeki çöküş , yaygın bir hastalık gibi [MASK] toplumu .	sarar
Ne yaman esiyor Şad'ın sazağı / Kahpe felek bize [MASK] tuzağı	kurdu
Her iki eliyle [MASK] makası ile tarağını .	kullanırdı
İçiyor , hiç durmadan içiyordu denizi / Bu içiş asırlarca susuz [MASK] bizi	bıraktı
Yanında binlerce kurbanlık ile / [MASK] düşmanı , bastı dayağı	Süpürdü
Aklın ermez , şeytanılain de aklıma [MASK] hep kötü şeyleri .	sokar
Babam kaşları çatılmış , başını sallayarak [MASK] bizi .	izliyor
Haydi Abbas , vakit tamam / Akşam diyordun işte [MASK] akşam	oldu
Çocuklar , türkülü bir tekerleme ile [MASK] leyleklerin gelişini .	karşılarlar
Çok sayıda amatör topluluk [MASK] Nalınlar'ı .	sahneledi
Şu yağan kar bir tutsun , [MASK] sen ertesi gün çocukları .	seyreyle
Cennet cennet dedikleri birkaç köşk ile birkaç huri / İsteyene [MASK] sen anı , bana seni gerek seni	ver
Yağışlı havalarda boydan boya gerili iki kalın ipe [MASK] çarşafları , çamaşırları .	serer
Göğüs bağır açık , ellerinde pankartlarla [MASK] bu savaşı .	yürütüyorlar
Konuşmaya dalınca farkında olmadan uzaklaşarak görüş alanından [MASK] hamam böceğini .	çıkarmıştı
Sabahları ekmek dağıtmaya çıkan , ayda bir de aidat toplayan Meryem dışında kimse [MASK] kapısını .	çalmazdı
Şimdiki aklım olsaydı bu dükkânın yerine [MASK] bir kahve !	aç
Omuzları çökmüş , kambur bir dilenciye [MASK] kendimi .	benzetiyorum
Biçare kadın iki gözü iki çeşme [MASK] bunları .	anlatmış
Yağmur yağar da ışılaşır sayları / Eli göçmüş de [MASK] daylağı	bozulaşır
Çirkin bana kurban , ben de güzele / Can [MASK] güzeli , maldan ziyade	sever
Alanları düşüncenin çakıntılarıyla aydınlanan kent / [MASK] varoşlarını genç ordularıyla eylemin	Genişletti
Bir çıkarı olsun olmasın , [MASK] çöpçatanlığa .	bayılır
Sandukanın yeşil çuhasına başını dayadığında , sanki bir el saçlarını okşayıp teskin [MASK] onu .	edecekti
Bütün bu söylediklerim birtakım belirlenimlere [MASK] beni .	iteliyor
Savaşlar girdi araya ; cinselliğin pek yırtık dışa vurumları [MASK] dünyayı .	kapladı
Ona en azından iyi duygulanımlar vermem gerekirken [MASK] onu .	üzüyorum
Masadakiler eğlenirlerken vali dalgınlaşmıştı , pek [MASK] konuşulanları .	dinlemiyordu
Biz iyi kötü tiyatroya [MASK] ekmeğimizi .	bağlamışız
Ne de olsa eski toprak , [MASK] bu vartayı da .	atlatır
Âlem içre muteber bir nesne yok devlet gibi / [MASK] devlet cihanda bir nefes sıhhat gibi	Olmaya
Ekici borç harç [MASK] tarlasını .	ilaçlayacaktı
Esen rüzgâr siliyor alnımdan kaderimi / [MASK] saçlarımı , yüzümü , ellerimi	Okşuyor
Sırasında ayrı siyasi kamplarda birbirlerinin karşısına çıksalar da düşman [MASK] birbirlerini .	görmezler
Onun bacağını kangren tehdit edip de tecrit ettiğimiz vakit daha iyi [MASK] onu .	tanıdım
O gün hakikat olur bu milletin rüyası / O gün bu millet [MASK] üstünden kara yası	atar
Bastığın yerleri toprak diyerek geçme , tanı / [MASK] altındaki binlerce kefensiz yatanı	Düşün
Ben kırkyıllık inşaatçıyım , [MASK] hepsini .	tanırım
Ali'mi korunaksız bırakma dağ başında ; [MASK] beni adı güzel , kendi güzel Tanrı'm !	duy
Her sabah koşar adım [MASK] mektebe .	giderdim
Cebimdeki paranın yarısını ayırıp avuç avuç ceviz alıyorum , sevinçle [MASK] ceplerimi .	dolduruyorum
Mağripten maşrıka dünyanın ucu / Sarrafı [MASK] altını , tuncu	bilir
Başhemşire , hastanenin mermer salonunda [MASK] doktoru .	karşıladı
Bir met zamanı gökyüzü kurşunla örtülü / [MASK] deniz dedikleri bin başlı ejderi	Gördüm
Şu sonsuz mavilikte var mıydı onun eşi ? / Kim [MASK] o muhteşem güneşi ?	söndürebilirdi
Kadı ola davacı ve muhzır dahi şahit / Ol mahkemenin hükmüne [MASK] mi adalet	derler
Ben suratımı buruşturdukça , bir yaz öğlesinde yarı açık kalmış bir musluktan akarak ak mermer bir yalakta şarkı söyleyen serin bir su gibi [MASK] o !	gülsün
Ama bu münferit hayranlıklar [MASK] bizi .	aldatmamalı
Yarın daha gün ışımadan [MASK] onları obadan .	kovduracağım
Her kim ki olursa bu sırra mazhar / Dünyaya [MASK] ölmez bir eser	bırakır
Heyecandan mest olarak öptüm elini / Sonra akşam yemeğine [MASK] beni .	çağırdı
Seni severim ; piyaz anlama bu lafımı , apaçık [MASK] her şeyi .	söylerim
Sırtına giymiş sıkma sayayı / Yedeğine [MASK] ağca mayayı	almış
Her çiçekten bal eyledik / Arıya [MASK] bizi	saydılar
Şu sonsuz mavilikte var mıydı onun eşi ? / Kim [MASK] o muhteşem güneşi ?	söndürebilirdi
Şnorkeli ısırıyordu , kauçuk ağızlığa basbayağı [MASK] dişlerini .	geçirmişti
Sen istediğin kadar taşla beni , gene de bir şiirle [MASK] işe .	girişeceğim
Yazınımızın gelenek değiştirmesine bağlı olarak değişik etkenleri [MASK] bu durumun .	var
Sattım dükkânı , [MASK] kendimi tiyatroculuğa .	verdim
Şu 70'li yılların incelenmesi töresel olarak tam bir çöküntü tablosu ile karşı karşıya [MASK] bizi .	bırakır
Köşede kuru odun var , [MASK] ocağı .	uyandır
Büyük bir karyola ve içinde ben uzanmışım , sen baş ucumda oturup sessiz [MASK] beni .	bekliyorsun
Allah'ım , sen [MASK] Muhammed ümmetini bu eşkıyanın zulmünden .	koru
Bilgiyi kurup iletmede konuşmanın başarısı [MASK] çok kimseyi .	şaşırtabilir
Yemekten sonra gocuğuna sarar [MASK] beni .	yatırırdı
Yolculukla ilgili işlemleri tamamlarken , koltuğuna [MASK] onu .	oturtmuştuk
Gösterip sivri uzun dişlerini bir daha / Bir zehirli ok gibi [MASK] bana kahkaha	attı
Tutarsa onun bir damarı , [MASK] adamın başına çadırı .	yıkar
Üvey annesi kalp yerine taş taşıdığından eziyet üstüne eziyet [MASK] el kadar yetime .	ederdi
Özgürlüklerini ellerinden alıp birer araç hâline [MASK] onları .	getiriyor
Böyle horoz gibi her lafın altından kalkarsan kocan tuttuğu gibi geri [MASK] seni .	yollar
Lakin siz , yine sabaha kadar kalacakmışız gibi idare [MASK] mumu .	edin
BEN GAYET MEMNUN [MASK] TEMİZLİKTEN .	KALDIM
SADECE TELEFONLA ARADI [MASK] KENDİSİYLE .	GÖRÜŞMEDİK
TAM PUAN VERİYORUM [MASK] BİZİMLE .	İLGİLENDİ
SAĞ OLSUN ÇOK [MASK] BİZİMLE .	İLGİLENDİ
FENA DEĞİLDİ MEMNUN [MASK] YEMEKLERDEN .	KALDIK
RAMAZAN BAYRAMINDAN SONRA GİDEBİLECEĞİMİZ AVRUPA TURLARI İLE ALAKALI BİLGİ ALMAK İSTİYORUM TEŞEKKÜR [MASK] SİZLERE .	EDERİM
RAMAZAN BAYRAMINDAN SONRA GİDEBİLECEĞİMİZ AVRUPA TURLARI İLE ALAKALI BİLGİ ALMAK İSTİYORUM TEŞEKKÜR [MASK] SİZLERE .	EDERİM
MEMNUN KALMADIM TAVSİYE [MASK] TESİSİ .	ETMEM
DAHA ÖNCEDEN SURVİVOR FİNALİ İZLEME ŞANSIM OLMUŞTU ÇOK [MASK] OTELİ .	BEĞENMİŞTİM
DAHA ÖNCEDEN SURVİVOR FİNALİ İZLEME ŞANSIM OLMUŞTU ÇOK [MASK] OTELİ .	BEĞENMİŞTİM
BAZI BANYO MALZEMELERİ EKSİLDİ [MASK] RESEPSİYONDAN BANYO MALZEMELERİ .	İSTEDİM
BAZI BANYO MALZEMELERİ EKSİLDİ [MASK] RESEPSİYONDAN BANYO MALZEMELERİ .	İSTEDİM
GENEL OLARAK MEMNUN [MASK] YEMEKLERDEN .	KALDIM
ÇOK GÜZEL BİR TATİL GEÇİRDİK HERKESE TAVSİYE [MASK] GÜZEL BİR TATİL .	EDERİM
ARTIK KAPADOKYADAKI TEK [MASK] TERASLI CAVE SUİT .	ADRESİMİZ
Bayan Brown Filipin diline karşı yaşanan modern zaman kültürel duygu karmaşasına şu adı [MASK] : " dil şizofrenisi . "	veriyor
Avukatlar buna şöyle [MASK] " olgu yoğunluğu . "	diyor
En dikkat çeken bölüm [MASK] : bir " koku kontrol sistemi . "	şuydu
Bu dünyevi , eğlendirici film çınlayan bir sesle cevap [MASK] : " evet . "	veriyor
Bir sonraki kamyondaki çiftçi şöyle [MASK] , buğday !	bağırıyor
" Çok iyi [MASK] ( Bay Phillips'i ) .	tanımıyorum
Ama ben başarısız olarak [MASK] Bay James'i veya diğer potansiyel teklifçileri .	görmezdim
ÇOK GÜZELDİ MEMNUN [MASK] TESİSTEN .	KALDIK
Rekabetçi teklif yoluyla 55730000 $ okul finansman [MASK] , 1989 Seri B ( 1987 kararı ) .	bonosu
