Top top olmuş güzellerin sürüsü / Öncül olmuş çeker [MASK] birisi	gider
İlk flörtünün onu yüzüstü bırakarak başka bir kızla çıktığı [MASK] yüzündeki bağışlamasız hüzün .	zamanlardandı
Yurtlarına bela getiren bu kadını , [MASK] kentin uluları .	ayıplamıyor
Sandallar tam bir hizaya gelince onları birbirlerine elleriyle bitiştirerek [MASK] kayıkçılar .	tutar
Bir hoşluğu [MASK] üstünde bugün / Dursun Ağa'nın / Biraz başı ağrıyor / Biraz dişi ağrıyor	var
Efil efil [MASK] yârin yüzünde / Zülüf müdür , perçem midir , tel midir ?	eder
Onun suçu [MASK] denizin alçalması / Tarlaların ekinsiz , davarın aç kalması	sayılır
Zevk [MASK] kadın terastan aşağı şakırdayan suların içinde süpürgenin fışırtılı müziğini duymaktan .	alıyor
Cesaret [MASK] değildi Cemal ama üç büyük birayı devirdikten sonra , kendi gözünü karartabileceği gibi başkalarınınkini de morartabileceğinden hiç şüphesi yoktu .	timsali
Sonra ver [MASK] ana baba ocağı .	elini
Konuk kadının durgunluğu evdeki tedirginliktendi , iğne üstünde oturuyormuşçasına [MASK] duruşu .	eğretiydi
İkrar [MASK] cahil gönlüm inandı / Seherin yelleri esti gelmedi	verdi
Evde kimsenin olmadığını telefonla iskandil ediyorlarmış [MASK] Bedri .	diyor
El yanında yıkar [MASK] kaşını / Tenhalarda gülüşünü sevdiğim	gider
Kolayına [MASK] bu dünyada hiçbir şey .	değişmiyor
[MASK] , kurban olayım çehreni ey nazlı hilal .	Çatma
Kaç gündür helak [MASK] fukara , biraz dinlensin ; kuş kadar canı var , temelli eriyip bitecek !	oluyor
Valinin yerini öğrendiği gibi [MASK] Bayram , İlyas'ı peşine takıp .	savuştu
Durmaz [MASK] gözüm yaşı sel gibi .	akar
On yedi yıldan sonra saçsız başımda tekrar eskisine yakın bir hızla esmeye [MASK] kavak yeli .	başlamış
Ruhsatlıdır , çekmeceye bakın belgeler orada , [MASK] adam telaşla .	diyor
Duyarlığı hastalık derecesinde yüksek , gerçekle bağlantısı zayıf , ürkek bir [MASK] İhsan , kavgadan gürültüden tun tun kaçıyordu .	çocuktu
Günbegün [MASK] dert ile gamım / Uç verdi yaralar sıralandı gel	artmada
Fincanlardan evvel , hemen arkalarında duran yuvarlak , vernikli , resimli tepsiye [MASK] eli .	uzandı
Hastalığı için , ciğerleri zayıf düşmüş , zafiyet geçiriyor , [MASK] doktorlar .	demişlerdi
Beni bir gözleri ahuya zebun [MASK] felek .	etti
Sessizce gezinecek çevresinde , durağan bir yıldız gibi gökle birlikte [MASK] o .	dönecek
Türküleriyle varoldu Kahramanmaraş'ın Elbistan ilçesinin Berçencik köyünde 1940 yılında [MASK] Mahsuni Şerif .	doğdu
56604 YILDIR SÜREKLİ OLARAK [MASK] PARK OTEL .	TERCİHİM
4 YILDIR SÜREKLİ OLARAK [MASK] PARK OTEL .	TERCİHİM
4 YILDIR SÜREKLİ OLARAK [MASK] PARK OTEL .	TERCİHİM
TEMİZ BİR [MASK] ODALARI .	TESİS
MERKEZE [MASK] TESİS .	YAKINDI
MERKEZE [MASK] TESİS .	YAKINDI
ÇOK [MASK] ANİMASYONLAR .	YETERSİZDİ
ÇOK [MASK] GEMİ .	ESKİYDİ
ÇOK [MASK] ODALAR .	ESKİYDİ
ÇOK [MASK] DENİZ .	DALGALIYDI
TEMİZ BİR [MASK] ODALARI .	TESİS
TEMİZ BİR [MASK] KONUMU .	TESİS
ÇOK [MASK] HAVUZ .	KİRLİYDİ
SAKİN BİR [MASK] PERSONELLERİ .	TESİSTİ
TEMİZ BİR [MASK] PERSONELLERİ .	TESİSTİ
ÇOK [MASK] HER ŞEY .	GÜZELDİ
ÇOK [MASK] ARKADAŞLAR .	İYİYDİ
ÇOK [MASK] TESİS .	PAHALIYDI
ÇOK [MASK] KOLTUKLAR .	İLGİLİLERDİ
ÇOK [MASK] HEPSİ .	İYİYDİ
ÇOK [MASK] DEĞİLDİ PERSONEL .	İLGİLİ
ÇOK [MASK] ANİMASYONLAR .	KÖTÜYDÜ
ÇOK [MASK] DEĞİLDİ TEMİZLİK .	İYİ
ÇOK [MASK] DEĞİLDİ YİYECEKLER .	İYİ
ÇOK MEMNUN [MASK] BEN .	KALDIM
TEMİZ BİR [MASK] ODALAR .	TESİSTİ
ÇOK [MASK] KOLTUKLAR .	SIKIŞIKTI
ÇOK [MASK] HİZMET .	GÜZELDİ
TEMİZ BİR [MASK] ODAM .	TESİSTİ
HİJYENİK BİR [MASK] KONUMU .	TESİSTİ
[MASK] ODA .	UFAKTI
[MASK] HAVUZU .	UFAKTI
YARDIMCI [MASK] KENDİSİ .	OLDU
KALİTELİ BİR [MASK] PERSONELLERİ .	TESİS
GÜLER [MASK] PERSONEL .	YÜZLÜYDÜ
GÜLER [MASK] PERSONEL .	YÜZLÜYDÜ
HALİKARNASA OTELDEN 1 KİŞİ 80 LİRA [MASK] ETS .	İSTEDİ
[MASK] HEPSİ .	GÜLERYÜZLÜ
[MASK] HER ŞEY .	GÜZELDİ
GÜLER [MASK] HERKES .	YÜZLÜYDÜ
GAYET [MASK] HER ŞEY .	GÜZELDİ
[MASK] ODAMIZ .	GÜZELDİ
HEP [MASK] YEMEKLER .	AYNIYDI
[MASK] ODAMIZ .	GÜZELDİ
[MASK] YEMEKLER .	HARİKA
GÖRSEL AÇIDAN ÇOK [MASK] YEMEKLER .	ZENGİNDİ
[MASK] TATİL .	HARİKA
EVET ÇOK [MASK] YEMEKLER .	KALİTELİYDİ
[MASK] EŞYALAR .	ESKİYDİ
[MASK] ODA .	DARDI
EMRE [MASK] REHBERİMİZ .	BEYDİ
[MASK] OTEL .	ESKİYDİ
DAMAK [MASK] GÖREYDİ YEMEKLER .	TADIMIZA
ENİSE [MASK] REHBERİMİZ .	HANIMDI
DAHA İYİ [MASK] YEMEKLER .	OLABİLİRDİ
CENGİZ [MASK] REHBERİMİZ .	BEYDİ
[MASK] OTEL .	ESKİMİŞ
Hiç belli [MASK] insanoğlu !	olmaz
Bu harp başına vurdu galiba , [MASK] sen .	sapıtmışsın
[MASK] domates , biber , soğan .	Burada
Türk romanının kısır döngülerden kurtulamamasını düşlemsizliğine [MASK] ben .	bağlıyorum
Hiç [MASK] miyim ben eli nimetli efendiciğimi kaptırayım o cilvebazlara ?	ister
[MASK] bu hafiflik çoktan menopoza girmiş bir kadına .	Yakışmıyordu
Sana [MASK] dökülen kanlarımız sonra helal .	olmaz
Karşılığı olmayan , içeriksiz ve yetersiz bir [MASK] mutluluk .	sözcüktür
İbni Haldun külliyatını tetebbu etmeyenlere sırlarını ifşa [MASK] eser .	etmez
Hacı Kalfa kaç baharın yoğurdunu yemiştir , [MASK] sen ?	bilirsin
Kurşunu yer yemez , kayalardan aşağı [MASK] leşi , ta derenin kucağına !	yuvarlanmış
Önüne [MASK] Mevlüt , ne diyeceğini bilemeden .	bakmıştı
Fırınlanmış birader , iki yıl sonra pul pul [MASK] mı bunun vernikleri ?	olmaz
Dünya üzerindeki tüm canlılara sebil edilmiş bir [MASK] değildir iğrenmek .	nitelik
Siper et gövdeni [MASK] bu hayâsızca akın	dursun
İbni Haldun külliyatını tetebbu etmeyenlere sırlarını ifşa [MASK] eser .	etmez
Turfa [MASK] artık eski felsefe .	oldu
Kara sevdalarını [MASK] uzaklarda / Çıplak kalan ağaçlar , sürüsüz çoban ve deniz	türkülüyor
Dünya üzerinde yersiz yurtsuz [MASK] iki arkadaş .	kalmış
Göz göz [MASK] yüreğim , gözlerinin derdinden	oldu
Kendi çıkarlarından başka bir şey [MASK] komisyoncu , anaforcu .	düşünmez
Sürüp [MASK] en sert ayazlarda bile / Bir tatlı sıcak kış vakti	gider
Fani bir iz [MASK] burda yatmışsa kimler / Aygın baygın mâniler , açık saçık resimler	bırakmış
[MASK] Baba .	Gül
Nice kahramanlar nice sultanlar / Gelmiş [MASK] bağrı yanık ozanlar	gitmiş
Her zaman bahçıvanlıkla [MASK] bir ihtiyar adam .	uğraşan
[MASK] milletin evladı da bangır bangır .	Ağlasın
Banyosuz , duşlu , avuç içi gibi bir [MASK] hamam .	aralıktı
Yeni bir sanat kuşağının [MASK] o .	bayrağıydı
Son gün hemen parasız çocuklara [MASK] bayram yeri .	kalırdı
Siman bedirlenmiş ay mı bilmem / Dökülmüş saçların [MASK] kara gözlüm	ör
Duraksadı , gülümsedi , kâğıda uzandı , yüzünden daha [MASK] eli , biçimliydi .	esmerdi
Yanılmaya , aldanmaya bazen engel olunamıyorsa da , vazgeçilmez bir bildirişme [MASK] dil .	ortamıdır
Her konuda rahat , bilgili [MASK] kalemi .	konuşurdu
[MASK] devlet cihanda bir nefes sıhhat gibi	Olmaya
Ve bir hamlede üçüncü bardaktan [MASK] boncuk .	çıkıvermişti
Hastalıktan ötürü engelliler bir yana , hep susan bir insan tasarlamaya [MASK] hayal gücüm .	yetmiyor
Yetişir koştuğum aşkın peşi sıra / [MASK] beni bu içki , bu kumar	Bitirdi
Onun gençliğinde pudralı [MASK] , kozmetikli bıyık , briyantinli saçtı güzel sanılan .	yanak
Bugünlük [MASK] bu kadar .	söyleyebileceğim
[MASK] gülleri boşlukta hava / Ve buhurdanda tüter amberler	Dağıtır
Gökler bulutlanıyor rüzgâr serinliyordu / Serpilmeye [MASK] bir yağmur ince ince	başladı
Cahillik devrimizin eşekliklerini saymazsak neye [MASK] bu ömür ?	yaradı
Beni [MASK] bir yol , ey cemaatimüslimin !	dinleyin
An [MASK] , çağıltılı bir dere kenarında saz / Kuş cıvıltıları	olur
Kızımın çeyizlik [MASK] onlar .	altınları
Haberini böyle fısıl fısıl anlatmaz , gümbür gümbür [MASK] çığırtkan dediğin .	yayar
Baş başa [MASK] seninle ıslak / Çimenlerine yaz bahçelerinin	uzandık
[MASK] mi Allah'ım bu çizgili yüz / Ya gözler altındaki mor halkalar	Benim
Boş [MASK] bunlar .	savlardır
Ne kadar toplasan perişandır / [MASK] saçlarım dağılmak için	Toplanır
[MASK] orta dereceli memurlar , zabitler , kadınlar .	Balkonda
Dini bütün gelin [MASK] ben .	isterim
Yaşar Kaptan dedikleri bir sarı yılan / Kayalar kadısını [MASK] divan	durdurur
Garp âleminde eğlenişin bir [MASK] bu .	misali
Hastalıktan ötürü engelliler bir yana , hep susan bir insan tasarlamaya [MASK] hayal gücüm .	yetmiyor
Yorgun , yıpranmış , esmerleşmiş [MASK] yüzü , tıraş olmamıştı .	gibiydi
Güneşin batıdan doğması gibi olağanüstü bir fenomen [MASK] bu .	sayılmalıdır
Kalenin gedikleri / [MASK] yedikleri	Şekerdir
Fırçayı tutamıyor parmakları nakkaşın / Mermeri oymaz [MASK] eli heykeltıraşın	oldu
Bilen bilir , kolay okunan [MASK] değildir , hazret .	yazar
İnsanı insan yapan duyguların [MASK] aşk .	ilkidir
Çekiştikleri [MASK] işlemeli bir kitap açacağı .	şey
Kakalamaktan parmak uçları delik [MASK] terzi çırakları , kalfalar .	deşik
Refika , valide , iki kerime [MASK] mı biz iki bin kuruş tekaüt maaşına .	kaldık
Bir daldan hızla geçip gitti bir kuş kanadı / Sessizlik bir tüy gibi bir dakika sallandı / [MASK] bir ateş böceği sarmaşıkta	Pırıldadı
Bana [MASK] , bu bir yığın ne olduğunu anlamadığım , karışık dolambaçlı işten !	ne
Kelebek gibi [MASK] ruhumuz / Barış dolu bu yıldız bahçesinde	uçmada
Keleci bilen kişinin yüzünü ağ ede bir söz / Sözü pişirip diyenin işini sağ [MASK] bir söz	ede
Kimden [MASK] bu kerata ?	yana
Öpüşürken , kokuşurken [MASK] kocası .	çıkageldi
Boşa kostaklanma [MASK] değilsin karam	kostak
Zengin sanılan evlere gidip boyun [MASK] Sultan .	büktü
Kükredi çimenler , açıldı güller / Al şala [MASK] bahçeler , bağlar	bürünür
Büyük bir [MASK] bu .	camiydi
Düşsün olur mu toprağa göçmüş cihan gibi / [MASK] o mavi gözleri bir asuman gibi	Sönsün
Fırçayı tutamıyor parmakları nakkaşın / Mermeri oymaz [MASK] eli heykeltıraşın	oldu
Gazino varmış / Denize karşı / Beni [MASK] / Dükkânlarıyla çarşı	oyalarmış
İğne ile kuyu kazmak gibi bir [MASK] oymacılık .	şeydi
Öğle uykusuna [MASK] yalı sakinleri .	dalmış
Balık ağı örerken , ağları tamir ederken [MASK] o !	okur
[MASK] bülbül .	Ötme
Yaşamayı belirleyen her şeye [MASK] toprak .	özlemliydi
Onların sıfır hisseye sahip olduğu paravan bir şirketin üzerine [MASK] apartman .	yapıldı
Ateş doludur tutma , yanarsın / [MASK] şu gülgûn piyale	Karşında
Yazısı silinmiş , kâğıdı sarı / Mektubunu geri [MASK] / Dünya postaları	getirdi
Müşkül budur ki ölmeden evvel [MASK] kişi .	ölür
Fincanlardan evvel , hemen arkalarında duran yuvarlak , vernikli , resimli tepsiye [MASK] eli .	uzandı
[MASK] o kalkışta ne mendil ne de bir kol .	Sallanmaz
Bu harp başına vurdu galiba , [MASK] sen.	sapıtmışsın
[MASK] seher yeli zülfün dağıtır / Gerdana dökülen tel incinmesin	Eser
[MASK] yalnız yaşayanlar / Nasıl korku verir sessizlik insana	Bilmez
Bundan âlâ seyri nerede [MASK] garipler ?	bulacak
Evlerinin önü bulgur sokusu / Yel estikçe [MASK] yarin kokusu	gelir
Çirkin bir [MASK] bu .	oyun
Sende [MASK] münfail , kırgın / Muzdarip gönlümün son ümidi	kalmıştı
İtalya'da büyük bir şirketin [MASK] ben .	acentesiyim
[MASK] ceplerinde tren tarifeleri .	Yıpranır
[MASK] bir tekinsiz kedi gibi sokaklar .	Ürperdi
Şu yağan kar bir tutsun , [MASK] sen ertesi gün çocukları .	seyreyle
Eli ayağı tutsun , açlıktan ölmesin , [MASK] ona .	yeterdi
Cennet cennet dedikleri birkaç köşk ile birkaç huri / İsteyene [MASK] sen anı , bana seni gerek seni	ver
Gören bizi sanır deli / Usludan [MASK] delimiz	yeğdir
Bir çeşit uygulama [MASK] yazdıkları .	oluyordu
Yılan masalı gibi uzadı [MASK] bu iş .	gitti
Çağımızın evrensel bir [MASK] yalnızlık , çünkü bütün insanlar yalnızdır .	yaşantısıdır
Ama bu kez bir ricada bulunmaktan ziyade icazet verircesine üst perdeden [MASK] sesi .	çıkmıştı
[MASK] sana vadettiği günler Hakk'ın / Kim bilir , belki yarın belki yarından da yakın	Doğacaktır
Erkek aşkı öyle uçsuz bucaksızdır ki / [MASK] bunun sonuncusu veyahut ilki	Olmaz
İstanbul'dan çıkar padişahın fermanı / Gökte [MASK] mızrağının yalmanı	döner
Gölgesinde koyun , kuzu yatışır / [MASK] , ladindir ormanlarımız	Servidir
İşte bu kadronun içinde [MASK] ben .	yetişecektim
Üç katlı , tahtadan , pimpirik bir [MASK] burası .	evdir
El ele vererek dost olduk hemen / [MASK] dostuyla birlikte giden	Yorulmaz
[MASK] bizim atımız	Yüğrüktür
Bizim gibi yüzyıllar boyunca egemen olmuş , imparatorluklar kurmuş , zaferler kazanmış bir ulus için ne yaman bir yüz [MASK] bu .	karasıdır
Senin anlayacağın , her telden [MASK] benim çocuklar .	çalıyor
Ama bu kez bir ricada bulunmaktan ziyade icazet verircesine üst perdeden [MASK] sesi .	çıkmıştı
İğne ile kuyu kazmak gibi bir [MASK] oymacılık .	şeydi
Eh [MASK] da delikanlı .	yakışıklı
O vakit o kış kıyamette / Ne kadar makbule [MASK] tatlı	geçer
[MASK] değildir varmadan senin gibi yurduna / Post verenler yabanın hayduduna , kurduna	Az
Hatırda kalan şey değişmez zamanla / Ne vefalı [MASK] sen Fahriye abla !	komşumuzdun
her çeşit kafa ve gönül fırtınalarına açık bir [MASK] o .	adamdı
Maalesef teknedeki alet edevatla beceremeyeceğiz bu işi diye [MASK] mühendis .	seslendi
Her milletten , her tabakadan , huyları , dinleri , dilleri farklı fakat amaçları aynı olan insanların bulunduğu bir [MASK] burası .	yerdi
[MASK] gülleri boşlukta hava / Ve buhurdanda tüter amberler	Dağıtır
O günlerde on beş [MASK] usta bir arıkçının gündeliği .	liraydı
Kötülüğün aşikâre yapıldığını hiç [MASK] mü Ali ağa ?	gördün
[MASK] o efendim bakkalın çakkalın , kasabın bile tutabildiği kümes gibi dar , bayağı , pis apartmanlar .	Nedir
Bütün sevgileri atıp içimden / Varlığımı yalnız ona [MASK] ben	verdim
Altı ayı aşkın bir zamandan beri [MASK] bu yolculuk .	hazırlanıyordu
Omzumda [MASK] el sıcaklığıyla / Anamın okşarken söylediği bir bismillah	kalmıştı
Su sesi ve kanat şakırtısından / Billur bir [MASK] Bursa'da zaman	avize
Böyle küme küme , böyle oğul oğul nerelerde [MASK] bunlar ?	toplanırdı
Doğrulup [MASK] yeryüzünde yeniden / Her silkinen , kalkınan , kurtulan ulusla sen	gürlüyorsun
Yâr ile buluşsak bir tenha yerde / [MASK] rakipler söz olur gider	Duyarlar
Can [MASK] bu .	pazarı
Salon penceresinin önündeki kafesinde cıvıl cıvıl [MASK] kanarya .	şakıyordu
Yaradılışı gereği çapraşık olmayan durumları [MASK] o .	severdi
Coşan sele dur [MASK] sen , dadı .	diyorsun
Çıkır çıkır bilezikli kolları / Söyledikçe şirin [MASK] dilleri	olur
[MASK] duvarı ocağın akisleri .	Çiçekliyor
Gömleğime yine çivit [MASK] annem .	koymuş
Bütün dünyaya [MASK] gözlerin .	değer
[MASK] o eski denemeciler , ağızlarından bal damlayan söyleşiciler ?	Nerede
Yüzleri tatlı , dilleri tatlı , dost [MASK] bunlar .	insanlardı
Düzce bir çizgide [MASK] bazen de adımları .	olurdu
Ne de [MASK] pat burnundaki mor mor meneviş .	ıslak
Sanki bir ecza [MASK] şu ısırgana benzeyen koyu yeşil ot .	kutusu
Koridor karanlık , alışkanlıkla elektrik düğmesine [MASK] ellerim .	uzanıyor
Başında elifî taç vardı , pek güzel , pek ışıklı bir [MASK] bu .	taçtı
Nereye [MASK] bu işin encamı ?	varır
Bu ensiz tahta köprü [MASK] ince dere .	altında
Münir , ezgince bir suratla : Ne yapayım efendibabacığım , geçinme [MASK] bu .	derdi
Bizi sarar bir sülüs yazı görsek duvarda / Bize heyecan [MASK] bir parça yeşil çini	verir
Yedi türlü çiçek vardır başında / [MASK] reyhan ile gül karmakarış	Kokar
[MASK] fiskoslar , gülüşmeler , fıkırtılar .	Hani
Gözlerinin altında keseler , torba torba [MASK] göz keseleri .	sarkıyor
Beni öldürmek için birisi fazla bile / Ancak onun elinden [MASK] böyle haile	çıkar
[MASK] mi Allah'ım bu çizgili yüz ? / Ya gözler altındaki mor halkalar ?	Benim
Har har , körükten çıkar gibi [MASK] nefesleri .	çıkıyordu
Ey vatanın bağrı yanık bucağı / [MASK] senin bereketli hasadın	Hani
Hay çok [MASK] sizler !	yaşayasınız
Sıcak bir ekmek gibi bölünebildiğini görünce [MASK] hayranlığımız .	artmış
Salonunda toplanmıştık geçen gece beş on kişi / [MASK] onun kendine has bir hikâye söyleyişi	Vardı
Bizim için çok enteresan bir [MASK] bu yeni icat .	şeydi
Âlem içre muteber bir nesne yok devlet gibi / [MASK] devlet cihanda bir nefes sıhhat gibi	Olmaya
Sızlatıcı bir içsel acıyı da dile [MASK] şair .	getirir
Ve [MASK] tavanlara bir içyağı kokusu .	siner
İdeolojik saplantıları olanlar için tekin [MASK] değil burası .	yer
Hasılı isyan bayrağını [MASK] Miralay Bey .	çekti
Mühim hadiselerin yanı sıra , acil durumların da şaşmaz [MASK] Celâl .	adresiydi
[MASK] gözümde kadın kahpeleştikçe .	Güzelleşir
Kalpsiz herifin [MASK] bu .	biri
Katıksız İstanbul çocuğu , Boğaziçi [MASK] o .	çocuğudur
Neyse yüzünün ve sesinin burukluğu çok sürmedi , çabuk [MASK] kekremsilik .	geçti
Neden sonra sarsıldı altımda demir yaylar / Gözlerimin önünden [MASK] kervansaraylar	geçti
Hiç değil beni kesmeden [MASK] o .	edemez
Kovboy bozuntusu yahut gangster torunu birkaç sivri [MASK] onlar .	akıllıdır
[MASK] müyüm ben köftün yiyecek ?	Öküz
[MASK] kör hatta gecede boş trenler .	Çekildi
Oyunların mekanizmasını sezince [MASK] birden dünya .	tekdüzeleşiyor
Dilde gam var şimdilik lütfeyle gelme ey sürur / [MASK] bir hanede mihman mihman üstüne	Olamaz
Bütün uzay araştırmacıları için yepyeni bir [MASK] bugün .	milattı
Ruhumun yaralarına mucizevi bir merhem gibi derman [MASK] uyku .	olsun
Ablak yüzlü , okkalı bir [MASK] nazır hazretleri .	adamdı
Beni öldürmek için birisi fazla bile / Ancak onun elinden [MASK] böyle haile	çıkar
Dünya güzelliği sendedir mevcut / Hususi özenmiş [MASK] mabut	yaratmış
Hiç kavgaya dönüşmemiş , edilgin bir [MASK] bu .	dargınlıktı
[MASK] o tabelaların , reklam levhalarının çirkinliği ?	Nedir
Ruhsatlıdır , çekmeceye bakın belgeler orada , [MASK] adam telaşla .	diyor
Ne vurdumduymaz [MASK] bunlar .	misafirdi
Hakikatten ne kadar uzaksa yalandan da o kadar [MASK] saçmalık .	uzaktır
Merhaba küçük kuşlar merhaba / Nedir bu sessizlik [MASK] selam sabah ?	hani
[MASK] kar soğuk gece yarısı .	Serpiştiriyordu
Maalesef teknedeki alet edevatla beceremeyeceğiz bu işi diye [MASK] mühendis .	seslendi
Hatta az önce Birgi'ye de [MASK] satışlar .	sıçramıştı
Baktım süzülüp [MASK] açıktan iki sandal .	geçti
Şen kahkahalar yükseliyorken evinizden / [MASK] geçen ey sevgili sandalla denizden	Bendim
Gece , ahenk içinde divanımı / Şenlendirse pırıl pırıl rakkaseler / Gece gece , her yanımı / [MASK] güller , laleler , menekşeler	Sarsa
Temelde sıradan bir Fransız vodviline [MASK] oynadıkları oyun .	dayanırdı
Bir kömür dumanıyla [MASK] akşamlar .	tütsülendi
Ruhsar Hanım uçuk bir gülümsemeyle kapıya süzüldü gitti , birkaç saat içinde birkaç yıl daha [MASK] kadıncağız .	yaşlanıvermiş
Fırınlanmamış birader , iki yıl sonra pul pul [MASK] mı bunun vernikleri ?	olmaz
Yüce dağların yağarı / Eridi [MASK] karı	kalmadı
Başı bir yana düşüverdi , [MASK] ağzından iplik iplik kan sızmaya .	başladı
Banyosuz , duşlu , avuç içi gibi bir [MASK] hamam .	aralıktı
Bizim de kalbimizi [MASK] yerinden / Toprağa diz vuruşu dağ gibi bir zeybeğin	kımıldatır
Bugünkü günde İngilizcesiz [MASK] çok iş .	olmuyor
Vazgeçin , [MASK] Nuh , kızlara yazık .	dedi
İnceldiği yerden kopsun ; kimsenin eline [MASK] , kapılara bakmamalı insan .	kalmamalı
Eşin var , aşiyanın var , baharın var ki beklerdin / Kıyametler koparmak neydi ey bülbül , [MASK] derdin ?	nedir
Rüzgâr gibi geçip giden gençliğimin [MASK] / Şu yıpranmış fotoğraflar , soluk renkli , siyah beyaz	tanıkları
[MASK] TESİS .	TEMİZDİ
[MASK] OTEL .	GÜZEL
[MASK] HERŞEY .	GÜZELDİ
[MASK] HAVUZ .	KÜÇÜKTÜ
EVET EVET [MASK] TEMİZLİK .	YAPILDI
ÇOK [MASK] ÇALIŞANLAR .	İYİ
[MASK] ODALAR .	MÜKEMMELDİ
[MASK] DEĞİLDİ YEMEKLER .	FENA
[MASK] TESİS .	TEMİZDİ
[MASK] ARKADAŞ .	İLGİLENDİ
ÇOK [MASK] YEMEKLER .	KÖTÜYDÜ
ÇOK [MASK] SERVİS .	MEMNUNUZ
[MASK] ODALAR .	SÜPERDİ
[MASK] DEĞİLDİ YEMEKLER .	LEZZETLİ
ÇOK [MASK] YEMEKLER .	KALİTELİYDİ
[MASK] YEMEKLER .	LEZZETSİZDİ
[MASK] ODAMIZ .	ESKİYDİ
ODAMDAN MEMNUN [MASK] YEMEKLERİ .	KALDIM
[MASK] YEMEKLER .	HARİKAYDI
[MASK] YEMEKLER ÇOK .	HARİKAYDI
TEMİZ BİR [MASK] KONUMU .	TESİS
[MASK] PERSONEL .	HARİKAYDI
[MASK] ODALAR .	ESKİYDİ
ÇOK [MASK] TATLILAR .	LEZİZDİ
ÇOK [MASK] HER ŞEY .	HARİKA
ÇOK [MASK] TESİS .	SÜPERDİ
BENCE GAYET [MASK] ODAMIZ .	GÜZELDİ
[MASK] ODA .	ESKİYDİ
[MASK] HAVUZU .	KÜÇÜKTÜ
5 YILDIZLI HOTEL [MASK] ODALAR .	KALİTESİNDEYDİ
[MASK] YEMEKLER .	SÜPERDİ
[MASK] DEĞİLDİ ODAMIZ .	TEMİZ
GÜNDÜZ SNACK BAR OLARAK KULLANILAN YER GECE DİSKOYA DÖNÜŞÜYOR OTELİN EN GÜÇLÜ [MASK] ÇALIŞANLARI KESİNLİKLE .	YANI
ÇOK [MASK] ODALAR .	KÜÇÜKTÜ
ÇOK [MASK] İÇECEKLER DE .	LEZZETLİYDİ
ÇOK [MASK] ODAMIZ .	FERAHTI
ÇOK [MASK] HER ŞEY .	GÜZELDİ
[MASK] OTEL .	İYİ
ÇOK [MASK] HAVUZ .	KÜÇÜKTÜ
ÇOK [MASK] YEMEKLER .	GÜZELDİ
ÇOK [MASK] ARKADAŞ .	İLGİLENDİ
[MASK] HER ŞEY .	FEVKALADEYDİ
[MASK] ODA .	KÜÇÜKTÜ
[MASK] ODAMIZ .	HOŞTU
[MASK] FİYATI .	UYGUNDU
[MASK] HAVUZ .	UFAKTI
[MASK] DEĞİLDİ YİYECEKLER .	LEZZETLİ
[MASK] DEĞİLDİ HAVUZ .	TEMİZ
[MASK] ODA .	İYİYDİ
DAHA GENİŞ [MASK] ODA .	OLABİLİR
ÇOK [MASK] ODAMIZ .	KÜÇÜKTÜ
EVET KONUMU BAKIMINDAN [MASK] ODA .	İYİYDİ
EVET KONUMU BAKIMINDAN [MASK] ODA .	İYİYDİ
[MASK] AKTİVİTELER .	YETERSİZDİ
[MASK] TEMİZLİK .	SÜPERDİ
SON DERECE [MASK] ODALAR .	KALİTELİYDİ
[MASK] HER ŞEY .	GÜZELDİ
[MASK] PERSONELLERİ .	GÜLERYÜZLÜ
ÇOK [MASK] KENDİSİ .	İLGİLENDİ
[MASK] TESİS .	İYİYDİ
ÇOK [MASK] HAVUZU .	KÜÇÜKTÜ
ÇOK [MASK] ODALAR .	KONFORLUYDU
[MASK] DEĞİLDİ ANİMASYONLAR .	YETERLİ
[MASK] YEMEKLER .	HİJYENİKTİ
[MASK] ANİMASYONLAR .	YETERSİZDİ
[MASK] KENDİSİ .	YURTDIŞINDA
[MASK] ANİMASYON .	ZAYIFTI
FİYATI [MASK] HİZMET .	KARŞILAMADI
ÇOK [MASK] ODA .	KÜÇÜKTÜ
ÇOK [MASK] KENDİSİ .	İLGİLİYDİ
TEMİZ BİR [MASK] YEMEKLERİ .	TESİSTİ
TEMİZ BİR [MASK] PERSONELLERİ .	TESİS
[MASK] ARKADAŞ .	İLGİLİYDİ
[MASK] ÇOCUK .	İLGİLENDİ
DAHA İYİ [MASK] HİZMET .	OLABİLİRDİ
EH İŞTE İDARE [MASK] ODA .	EDERDİ
[MASK] ODALAR .	KÜÇÜKTÜ
[MASK] ODAMIZ .	KÜÇÜKTÜ
[MASK] ANİMASYON .	YETERSİZDİ
[MASK] DIŞINDA KENDİSİ .	YURT
[MASK] TEMİZLİK .	İYİYDİ
[MASK] KENDİSİ .	İLGİLENDİ
[MASK] ARKADAŞLAR .	İLGİLENDİ
[MASK] ARKADAŞLAR .	İLGİLİYDİ
ÇOK MEMNUN [MASK] BİZ .	KALDIK
[MASK] DEĞİLDİ YEMEKLER .	İYİ
[MASK] ODAMIZ .	HARİKAYDI
ÇOK [MASK] ODA .	KONFORLUYDU
[MASK] ODA .	HARİKAYDI
TEMİZ BİR [MASK] PERSONEL .	TESİS
[MASK] TESİS .	SÜPERDİ
ÇOK [MASK] ODAMIZ .	GÜZELDİ
[MASK] YEMEKLER .	KÖTÜYDÜ
ZAMANINDA [MASK] TEMİZLİK .	YAPILDI
BİRAZ [MASK] ODAMIZ .	ESKİYDİ
HİÇ [MASK] DEĞİLDİ .	TEMİZ
ÇOK [MASK] TEMİZLİK .	MÜTHİŞTİ
ÜCRETİ [MASK] HİZMET .	KARŞILAMADI
GAYET [MASK] HER ŞEY .	GÜZELDİ
[MASK] DEĞİLDİ ODA .	TEMİZ
BU KARIŞIKLIKTA BAKTIĞIMA EN ÇOK EMİN OLDUĞUM YER PİKENİN ALTINDAN [MASK] TELEFONUM VE SIRITA SIRITA UZATTILAR .	ÇIKTI
DAHA İYİ [MASK] TESİS .	OLABİLİRDİ
[MASK] HER ŞEY .	MUHTEŞEM
MEHMET [MASK] REHBERİMİZ .	BEYDİ
[MASK] YEMEKLER .	VASATTI
ÇOK [MASK] HER ŞEY .	GÜZELDİ
HOŞUMA [MASK] ODALAR .	GİTTİ
TEMİZ BİR [MASK] PERSONELLERİ .	TESİSTİ
[MASK] YEMEKLER .	KALİTESİZDİ
CEP TELEFONUMA [MASK] KAMPANYALAR .	GELSİN
CEP TELEFONUMA [MASK] KAMPANYALAR .	GELSİN
SAMİMİ VE GÜLER YÜZLÜ [MASK] HEPSİ .	ÇOCUKLAR
DAHA İYİ [MASK] KALİTESİ .	OLABİLİRDİ
DAVUT [MASK] REHBERİMİZ .	BEYDİ
EVET ÇOK [MASK] YEMEKLER .	ÇEŞİTLİYDİ
[MASK] ODA .	ESKİYDİ
ÇOCUKLU AİLELER İÇİN [MASK] BİR OTEL .	UYGUN
EVET ÇEŞİT ÇOK [MASK] YEMEK .	ÇEŞİTLİYDİ
[MASK] TESİS .	TEMİZDİ
[MASK] ODALAR .	BAKIMSIZDI
[MASK] ODAMIZ .	UFAKTI
[MASK] YİYECEKLER .	VASATTI
YARDIMCI [MASK] ARKADAŞ .	OLDU
YARDIMCI [MASK] ARKADAŞLAR .	OLDU
[MASK] YÖNELİKTİ YEMEKLER .	YABANCILARA
YEMEKLER KONUSUNDA ÜSTÜNE [MASK] BU OTELİN .	YOK
MÜKEMMEL [MASK] YEMEKLER .	SAYILIR
ÇOK [MASK] YEMEKLER .	LEZZETLİYDİ
TEMİZ BİR [MASK] KONUMU .	TESİSTİ
GENELDE [MASK] BİR TESİS .	GÜZEL
GENELDE [MASK] BİR TESİS .	GÜZEL
TEMİZ BİR [MASK] KONUMU .	TESİS
TEMİZ BİR [MASK] PERSONELLER .	TESİSTİ
[MASK] HER ŞEY .	MÜKEMMELDİ
ÇOK [MASK] TESİS .	KALABALIKTI
TEMİZ BİR [MASK] PERSONEL .	TESİS
ÇOK [MASK] ONLAR DA .	İLGİLİYDİ
ÇOK [MASK] FİYATI .	YÜKSEKTİ
ÇOK [MASK] DEĞİLDİ YEMEKLER .	KALİTELİ
ODAMDAN MEMNUN [MASK] YEMEKLERİ .	KALDIM
[MASK] OTEL .	SÜPER
[MASK] ONLAR .	İYİYDİ
[MASK] TESİS .	TEMİZDİ
PROBLEM OLMADI GERÇEKTEN ÇOK [MASK] HER ŞEY .	GÜZELDİ
ÇOK [MASK] YEMEKLER .	GÜZELDİ
[MASK] DEĞİLDİ ODAMIZ .	KONFORLU
[MASK] YEMEKLER .	KUSURSUZDU
[MASK] HAVUZ .	KİRLİYDİ
ÇOK [MASK] HER ŞEY .	GÜZELDİ
TEMİZ BİR [MASK] ODALARI .	TESİSTİ
BİRAZ [MASK] TESİS .	PAHALIYDI
ÇOK [MASK] ODAMIZ .	GÜZELDİ
TEMİZ BİR [MASK] PERSONELLER .	GEMİYDİ
[MASK] HER ŞEY .	HARİKAYDI
[MASK] DEĞİLDİ YEMEKLER .	GÜZEL
GÜLER [MASK] PERSONELLER .	YÜZLÜ
TEMİZ BİR [MASK] PERSONEL .	TESİS
[MASK] PERSONELLER .	YETERSİZDİ
[MASK] HİZMET .	YETERSİZDİ
[MASK] YEMEKLER .	ZAYIFTI
TEMİZ BİR [MASK] PERSONELLERİ .	TESİS
ÇOK [MASK] ODA .	ESKİYDİ
YUSUF [MASK] REHBERİMİZ .	BEYDİ
[MASK] HER ŞEY .	YOKTU
[MASK] HER ŞEY .	GÜZELDİ
HİÇ [MASK] ANİMASYON .	YOKTU
DAHA UYGUN [MASK] FİYAT .	OLABİLİRDİ
ÇOK MEMNUN [MASK] HER ŞEY .	KALDIK
FİYAT PERFORMANS OLARAK [MASK] OTEL .	YETERSİZDİ
GAYET [MASK] HER ŞEY .	İYİYDİ
EYLEM [MASK] REHBERİMİZ .	HANIMDI
ERAY [MASK] REHBERİMİZ .	BEYDİ
[MASK] DEĞİLDİ HAVUZ .	DERİN
GAYET [MASK] ARKADAŞ .	İLGİLİYDİ
DAMAK TADIMA [MASK] YEMEKLER .	UYMADI
DAHA UYGUN [MASK] FİYATI .	OLABİLİRDİ
EV YEMEKLERİNİ [MASK] OTELİN YEMEKLERİ .	ARATMADI
DÖNE [MASK] REHBERİMİZ .	HANIMDI
[MASK] PERSONEL .	GÜLERYÜZLÜYDÜ
[MASK] YEMEKLER .	GÜZELDİ
[MASK] PERSONEL .	GÜLERYÜZLÜ
[MASK] HEPSİ .	HARİKAYDI
[MASK] HER ŞEY .	GÜZELDİ
BELLBOYUN 2 VALİZLİ ELİNE ALIP 3. İÇİN SİZ ALIRSINIZ DİYEBİLECEĞİ KADAR [MASK] PERSONELLER .	RAHAT
[MASK] YEMEKLER .	UYGUNDU
[MASK] YEMEKLER .	MÜKEMMELDİ
[MASK] HİZMET .	MÜKEMMEL
[MASK] HER ŞEY .	MUHTEŞEMDİ
[MASK] DEĞİLDİ YEMEKLERİ .	LEZZETLİ
[MASK] ODA .	TEMİZDİ
[MASK] TATLILAR .	MÜKEMMELDİ
[MASK] YEMEKLER .	MÜTHİŞTİ
[MASK] SALATALAR .	MÜKEMMELDİ
[MASK] ODA .	BAKIMSIZDI
[MASK] TESİS .	MÜKEMMEL
[MASK] TESİS .	PAHALIYDI
BİRAZ [MASK] HAVUZ .	KÜÇÜKTÜ
ÇOK [MASK] ANİMASYON .	ZAYIFTI
BİRAZ [MASK] ODA .	ESKİYDİ
BİRAZ DAHA UYGUN [MASK] FİYATI .	OLABİLİRDİ
BİRAZ [MASK] ODA .	KÜÇÜKTÜ
BENCE [MASK] TEMİZLİK .	YETERLİYDİ
BİRAZ [MASK] ÜCRETİ .	FAZLA
[MASK] PERSONELLER .	İLGİSİZLERDİ
TEMİZ BİR [MASK] YEMEKLER .	TESİS
[MASK] ÇOCUKLAR .	İYİYDİ
ÇOK [MASK] ANİMASYON .	KÖTÜYDÜ
[MASK] YEMEKLER .	İYİYDİ
ÇOK [MASK] DEĞİLDİ ODA .	TEMİZ
ÇOK [MASK] DEĞİLDİ ODAMIZ .	TEMİZ
ÇOK MEMNUN [MASK] HER ŞEY .	KALDIM
ÇOK [MASK] AKTİVİTELER .	KÖTÜYDÜ
[MASK] ARKADAŞLAR .	İYİYDİ
ÇOK [MASK] DEĞİLLERDİ PERSONELLER .	İLGİLİ
[MASK] HER ŞEY .	İLGİLENDİ
[MASK] ODA .	İYİYDİ
ÇOK [MASK] FİYATLAR .	YÜKSEK
ÇOK [MASK] DEĞİLDİ YİYECEKLER .	LEZZETLİ
[MASK] ÇOCUK .	İYİ
ÇOK [MASK] YEMEKLER .	YAĞLIYDI
ÇOK YARDIMCI [MASK] KENDİSİ .	OLDU
LEVENT [MASK] REHBERİMİZ .	BEYDİ
[MASK] OTEL .	SÜPER
[MASK] ANİMASYON .	YOKTU
[MASK] DEĞİLDİ YEMEKLER .	KALİTELİ
[MASK] DEĞİLDİ TEMİZLİK .	YETERLİ
TEMİZ BİR [MASK] YEMEKLER .	TESİSTİ
MERKEZE [MASK] KONUMU .	YAKINDI
[MASK] TEMİZLİK .	YETERSİZDİ
SUAT [MASK] REHBERİMİZ .	BEYDİ
TEMİZ BİR [MASK] PERSONELLERİ .	OTELDİ
SAKİN BİR [MASK] KONUMU .	TESİSTİ
[MASK] TEMİZLİK .	KALİTELİYDİ
TEMİZ BİR [MASK] PERSONELLERİ .	TESİS
[MASK] YEMEKLER .	SÜPER
[MASK] ÖYLE BİR ŞEY .	YOKTU
[MASK] BİR ŞEY .	YOKTU
YURTDIŞINDA [MASK] KENDİSİ .	YAŞIYOR
ÇOCUKLU AİLELER İÇİN [MASK] OTEL .	GÜZEL
KALİTELİ BİR [MASK] HİZMET .	TESİS
HER ŞEY DAHİL TESİSLERDE NE YİYECEĞİNİ [MASK] İNSAN AMA BURADA GERÇEKTEN YİYEBİLECEĞİN AZ ÖZ YEMEK ÇEŞİDİ İLE BİZE YETTİ DE ARTTI BİLE .	ŞAŞIRIYOR
5 [MASK] BALIK .	PUAN
[MASK] PERSONELLER .	GÜLERYÜZLÜ
BİR CUMARTESİ GÜNÜ ESİMLE KAFA DİNLEMEK İÇİN TATİL ARAYIŞIMIZDA KARŞIMIZA ÇIKAN OTELDİ [MASK] CAVE SUİT .	AYRICALIK
Vurucunun atış yapınca başlangıç plakasından uzaklaşmasını bekleyin ama topun bilerek vurucunun başına doğru fırlatılmasını beklemeyin [MASK] Bay McEnaney .	diyor
[MASK] : 3.14 milyar Dolar	Gelir
" [MASK] böyle şeyler . "	Olur
[MASK] bu nokta ?	Nedir
Yine de şu anda yasayı yapan [MASK] onlar .	hakimler
En yaygın şirket alımı [MASK] : kaldıraçlı satın alımlar .	yöntemi
Bu biraz rahatsız edici , [MASK] Bayan Kleinman .	dedi
Yardım hibeleri için neden bir aracı olayım ki ? diye [MASK] emeklilerden biri .	soruyor
" Kendi arazim üzerindeyim , " [MASK] Bay Pyszkiewicz .	diyor
" Anlatılan hikâyelerin hepsi boş , " [MASK] bir British Air sözcüsü .	dedi
Kimse paniklemedi , [MASK] bir sözcü .	diyor
" Görsel anlamda oldukça karmaşıklar , " diye [MASK] LSI grafik uzmanı Robert Seltzer .	açıklıyor
" Her tanık , resmi bir mahkeme celbi alır '' [MASK] ona temsilci Gonzalez .	dedi
" Bu çok açıklayıcıdır ve gerçek duyguların açığa çıkmasıdır , " [MASK] Bayan Volokh .	dedi
" Anne mülayimliğe inanmıyor , " [MASK] Bayan Smith .	dedi
" Hayatının gidişatı beklemedik şekilde işliyor , “ [MASK] Bayan Volokh .	dedi
" Biz niş bir pazar bulduk , “ diye [MASK] Bay Mills .	böbürleniyor
" Benim tarzım daha az laubali , " [MASK] Sayın Brawer .	diyor
" Hepimiz çok samimiyiz , " [MASK] Sayın Brawer .	diyor
O zamanlar değişikliklerin çoğunu yaptığını [MASK] pilotlar .	söylüyor
" O gerçek bir Wheaties-Box sporcudur , " diye yağlayıp [MASK] Bay Jones .	ballıyor
" İttifakların çok önemli olduğunu düşünüyoruz , " [MASK] Sayın Eddington .	diyor
Kısıtlanmış giriş uygulaması kuralları düzensizdi , [MASK] bölge sakinleri .	diyor
" Bu korkutucu , " [MASK] Bay Shattuck .	dedi
" Oldukça büyük bir trafik sıkışıklığı bekliyoruz , " [MASK] bir yetkili .	dedi
" Atinalılar Spartalılarla anlamına gelir " [MASK] Sayın McDonough .	diyor
Pittston yedek işçi alımına devam ediyor , [MASK] şirket .	dedi
" 4 Hazirandan bu yana gidişat daha da kötüleşti , “ [MASK] Bay Lai .	diyor
" Çoğu Amerikalı yatırımcı sadece vazgeçti , " [MASK] Bay Brody .	diyor
Hisselerinin iyi bir yatırım olduğunun düşünüldüğünü [MASK] IBM .	söylüyor
Perşembe gecesi devralma için yaptığı planların değişmediğini [MASK] Sir James .	söyledi
Her iki bölge de Basf için en hızlı büyüme kaydeden alanlar , [MASK] şirket .	dedi
" Siz teklifinizi gönderin " [MASK] Felipe Bince Jr .	diyor
Gümüş'ün geçmişindeki volatilite de yatırımcıların cesaretini kırıyor [MASK] satıcılar .	diyor
" Sarışınlar , kokain ve Corvette marka arabalar " diye [MASK] Bay McClelland .	mırıldanıyor
" Belki de sadece savunmasız bir zamanıydı " [MASK] Bay Cortese .	diyor
" Bunlar benim zamanlarım " [MASK] Bay Florio .	diyor
" Bizim Birkaç bombamız olmuştu , " diye itiraf [MASK] Bay Peters .	ediyor
" Japonlar geleceği dikkate alır . " [MASK] Bay Veronis .	dedi
Biz Bu değişiklikleri desteklemeye hazırız , " [MASK] Sayın Mosbacher .	dedi
" Bizim hala sıkı beysbol fanlarımız var , " diye [MASK] sözcü .	konuştu
Lonrho , Societe Commerciale için önümüzdeki sermaye artışına katılacak [MASK] Paribas .	dedi
Bay Agnos davetiyeleri reddetti , [MASK] Beyaz Saray .	dedi
Teknoloji hisseleri , [MASK] Bay Goldman .	diyor
" İnsanlar ille de korkuya kapılmıyor , " [MASK] Bay Litvack .	dedi
" Sorun yok , " diye cevap [MASK] Bay Sagan .	veriyor
" Herkes ondan korkuyordu , " [MASK] Bay Ingersoll .	diyor
Havalimanının en büyük uçak yakıtı [MASK] Sovyetler Birliği .	tedarikçisi
" Gerçekten iyi , '' [MASK] tropik kampta öğle sıcağında çalışan 39 yaşındaki Pete Broberg .	diyor
" Dikkat , " diye [MASK] pilotumuz sepetimiz kanala dalarken .	bağırdı
" Kimin ayağına bastığımı bilmiyorum , " [MASK] hakim .	diyor
Bu ilk uyaran nereye gidiyor? diye [MASK] SUNY'den nörolog Paul Maccabee .	haykırıyor
Japonya'nın yurtdışına yatırdığı paranın sadece [MASK] bu .	%1'i
`` Biz birçok fare sürüsü yuvasını temizledik , '' [MASK] 60 yaşındaki güvenlik emeklisi .	dedi
" Georgia-Pacific'in teklifi kesinlikle manzarayı değiştirdi , " [MASK] Oppenheimer & Co'dan Gary Palmero .	diyor
`` Sahip olmadığımız temsili arıyoruz '' [MASK] bir uzman .	dedi
Yaklaşık 1150 çalışan yeni anlaşma tarafından kapsanıyor , [MASK] Deere .	dedi
`` Her şeyi açıkladı mı emin değilim , '' [MASK] Bayan Stinnett istemeyerek .	dedi
` Fast-food işler ne kadar ödeme yaparsa yapsın popüler değildir , '' [MASK] bir Tufts memuru .	dedi
`` Ben kim olursa olsun kazanan kişi için üzülüyorum '' [MASK] Brezilyalı diplomat .	diyor
`` Bu gerçekten 21. yüzyıl hastanesinin bir parçası , '' [MASK] Dr Grieco .	diyor
O kadar hızlı değil , [MASK] Oklahoma'lı Cumhuriyetçi Mickey Edwards .	diyor
`` Onlar faturalarını ödemeye devam etti ve bunu yapacaktır '' [MASK] Bayan Sanger .	dedi
`` Dalları sadece boş salonlar üzerinde ısındı , '' [MASK] Bay Konheim .	diyor
Gün içinde değer kaybeden hisseler aktif ABD operasyonları olanlardı , diye [MASK] bayiler .	belirtti
Değişmediği sürece , onlar kaybedecek [MASK] demokratik liderlik yardımcısı .	dedi
' Bizim sepetlerimiz olsaydı , kutulardan ayrılırdık , ' [MASK] bir tüccar .	dedi
`` Biz burada herhangi bir soğuk hava görmüyoruz , '' [MASK] New York'tan Bay Bolling .	dedi
IMA Holdingleri edinimi tamamlanması için derecesini bugün düşürmesi bekleniyor [MASK] Moody .	dedi
`` Liderlik kazanmak önemli '' [MASK] bir Toshiba sözcüsü .	diyor
Hareket hissedarları ödüllendirir ve stokların likiditesini artırmak gerektiğini , [MASK] Oneida .	söylüyor
Yaklaşık 1.1 milyon C Sınıfı garanti verilmiş , [MASK] şirket .	dedi
`` Bunun bir rütbe indirgeme olması amaçlanmamıştır , [MASK] sözcü .	dedi
Fast food şirketi `` yoğun rekabetçidir '' [MASK] Wertheim Schroder analisti John Rohs .	diyor
`` Pazar daha iyiye gitti ancak muazzam bir geri dönüş değildi , '' [MASK] Bay Zipper .	dedi
Belki diğerlerinin fark edemediği değerleri fark ediyoruz '' [MASK] Bay Pilson .	diyor
`` Bu ürünler bizim iletim-ürün hattının kalbidir , '' [MASK] Bay Buchner .	dedi
`` Doğru olduğunu düşünüyorum , '' [MASK] Bay Bush açıkça .	dedi
" Bu teklifi diğer tüm alternatiflerle birlikte düşünüyoruz '' [MASK] güven sözcüsü .	dedi
Sorun Moody'nin gelen bir çift A notu alması bekleniyor , [MASK] sigortacı .	dedi
3 Ocak 1989'dan 31 Ekim 1997'ye [MASK] her 5000 İsviçre Frangı tahvili .	dönüştürülebilir
Yöneticiler “ bazı çok geniş takdir yetkisine sahiptir ” [MASK] Walt Disney Co .	diyor
" Aradığım dergiler az gelişmiş , " [MASK] Bay Ritterman .	dedi
" Mort'un eski şovunun yüzde doksanı tarzımıza uyuyor , " [MASK] Bay Eskridge .	dedi
" Bir veya iki tane seçiyorum , " [MASK] rehber kıkırdayarak .	diyor
" Burada güney Teksas'ta Tie-vole-ee diyoruz , '' diye nazikçe [MASK] ev sahibim .	düzeltti
Nispeten istikrarlı döviz ilişkilerinde Pazartesi piyasa oyuncuları tarafından olumlu görüntülendi , diye [MASK] tüccarlar .	söyledi
`` Bir bakıma , budur ' diye kabul [MASK] Bay Gonzalez .	ediyor
`` Bunun gibi güç isimler şehrin itibarına zarar vermez , '' [MASK] Miller .	diyor
`` Yakalanırsan suda ölürsün , '' [MASK] Bay Thal .	diyor
Bunun nedeni sadece " sade " isimler bırakmalarıdır [MASK] bay Churchill .	diyor
`` Hükümet kimseye yardım etmiyor mu ? '' diye [MASK] Bay Lesko'nun asistanı Toni Murray .	sordu
Onlar kurulu temsile devam ediyordu , '' [MASK] Bay Lloyd .	dedi
`` Herhangi bir koşulda , Suudi Arabistan daha azdan ziyade daha fazla almalı , [MASK] Bay Nazer .	dedi
`` Iddiaların ölçüsü bir süre bilinmeyecek , '' [MASK] Bay Leach .	dedi
" Bu , çok fazla korunmaya çalışmanın sorunu '' [MASK] Bay Brouwer .	dedi
`` Sadece bir vardiya başlangıcını görüyoruz '' [MASK] Bay Smith .	diyor
`` Nakliyatçılar `parti bitti diyor , '' [MASK] Bay Lalonde .	dedi
`` Brüt marjları üzerindeki olumsuz basınç ... yatışmış , '' [MASK] Sayın Sculley .	dedi
`` Bu tam bir şoktu '' [MASK] 43 yaşındaki Doğu Alman dükkân sahibi .	diyor
`` Gümüş üretimi amansız artış eğiliminde , '' [MASK] Bayan O'Connell .	dedi
" MMI pozisyonlarında büyük bir artış olmuştur " [MASK] Bay Selkin .	dedi
`` Ben dindar katoliğim , '' [MASK] , 40 yaşındaki sağlık memuru Bay Pignatelli .	dedi
`` Denemeden bilemezsin , '' [MASK] siyahi kayakçı .	diyor
`` Size düşmenin bir sorun olmadığını göstermek istiyoruz '' [MASK] Bayan Dillmann .	diyor
Şirket tahvilleri `` genellikle bir durgunluk içinde iyi bir bahis değildir , '' [MASK] Bay Wyss .	diyor
`` Biz kömür parçalarında büyüme gözlemledik , '' [MASK] Bay Hutchinson .	dedi
`` Ben , Roger'e kırgındım ve çok üzgün olduğumu dile getirdim , '' [MASK] Bay Peters .	diyor
`` Onlar her zaman dinledi , ama asla hareket etmediler , '' [MASK] Bay Guber .	diyor
`` Ekonomi sert çöküyor , '' [MASK] Pekinde Asyalı bir ekonomist .	diyor
`` Onlar birbirlerinin sık sık karşısındaydılar , '' [MASK] Bay Thompson .	dedi
Union Pacific Resources ünitesinin devam eden operasyonlarından kazancı neredeyse iki katında , [MASK] şirket .	dedi
`` Onlar rekabet duyurularıyla dolu basın bültenleri istiyor , `` [MASK] Bay Amram .	diyor
Bilgisayar seçimi mükemmel değil , '' [MASK] Harvey Golomb , Pinpoint başkanı ve kurucusu .	dedi
`` Yapı , insan ve plana sahibiz , '' diye ifade [MASK] Bay Işler .	etti
Önlem mekanizmaları devreye sokmak için zamanınız var '' diye [MASK] Vista sözcüsü .	belirtiyor
Fed yetkilileri muhtemelen oranlarını hemen aşağı çekmez , [MASK] Bay Keith .	dedi
`` Teksaslılar bir sahtekarı bir mil uzaktan koklayabilirler , '' diye [MASK] yabancılar .	anlatıyor
Ancak bu gelişmelerin hiçbiri büyümeyi hızlandırmak için pek bir şey yapmadı , [MASK] bay Sit .	dedi
Bu kadar kötümser [MASK] Bay Büyükelçi .	olmayın
Kimsenin oradan ayrıldığını sanmıyorum diye [MASK] Dixie .	fısıldadı
`` Onlar mükemmel bir iş yaptı , '' [MASK] Bay Phelan uzmanlar hakkında .	dedi
Biraz sabırla , bu işletmeler çok tatmin edici bir performans sergileyecek , [MASK] Bay Sim	diyor
[MASK] BAZI YEMEKLER .	SOĞUKTU
TEMİZ BİR [MASK] PERSONEL .	TESİSTİ
ALİ [MASK] REHBERİMİZ .	BEYDİ
ANKETE [MASK] BEN .	KATILDIM
[MASK] TESİS .	HARİKAYDI
ÖDEDİĞİM ÜCRETİ [MASK] HİZMET .	KARŞILAMADI
[MASK] KENDİSİ .	İLGİLİYDİ
[MASK] PERSONELLER .	İLGİSİZDİ
ÇOK [MASK] HAVUZ .	KALABALIKTI
ÇOK [MASK] ARKADAŞLAR .	İLGİLENDİ
ÇOK [MASK] KENDİSİ .	İYİYDİ
ÇOK [MASK] DEĞİLDİ PERSONELLER .	İLGİLİ
GAYET [MASK] ARKADAŞLAR .	İLGİLİYDİ
[MASK] MOBİLYALAR .	ESKİYDİ
MUSTAFA [MASK] REHBERİMİZ .	BEYDİ
ÇOK [MASK] ARKADAŞ .	İLGİLİYDİ
ÇOK [MASK] DEĞİLDİ YEMEKLER .	İYİ
ÇOK [MASK] ARKADAŞLAR .	İLGİLİYDİ
ODA DEĞİL [MASK] ODA .	CENNET
ÇOK [MASK] DEĞİLDİ YEMEKLER .	LEZZETLİ
TEMİZ BİR [MASK] PERSONELLER .	TESİS
ÇOK [MASK] HER ŞEY .	İYİYDİ
İLGİLİ [MASK] ARKADAŞLAR .	ALAKALI
[MASK] HER ŞEY .	SÜPERDİ
TEMİZ BİR [MASK] DENİZİ .	TESİS
[MASK] ÇEŞİTLER .	HARİKAYDI
[MASK] PERSONEL .	GÜLERYÜZLÜ
[MASK] HAVUZ .	GÜZELDİ
[MASK] PERSONEL .	YETERSİZ
[MASK] ANİMASYONLAR .	ZAYIFTI
HOŞUMA [MASK] ODALAR .	GİTTİ
1 milyar dolar artıda olabilirler , [MASK] Bay Richardson .	dedi
Örnekler [MASK] " Jaguar'a bakan Ford , LIN Broadcasting'a bakan BellSout "	arasında
`` Onlar tekrar yakalanmak istemiyorlar , '' [MASK] bir sektör gözlemcisi .	dedi
" Bu , P&G'nin Kao ile veya Kao olmadan yapacağı bir şey '' [MASK] Zurkuhlen .	diyor
" Gerçek bir gişe rekortmenine dönüşüyor , " [MASK] Sweig .	dedi
" ( Güçlü ) dolar Pfizer'e de çok zarar verdi , " [MASK] Bay Sweig .	dedi
" Eşantiyon insanlara sadece yanlış imaj veriyor , " [MASK] Bay Heinemann .	dedi
" Soru , her okuyucudan ne kadar alacağımızdır , " [MASK] Bay Heinemann .	dedi
