how many first class [MASK] does united have today	flights
how many first class [MASK] does united airlines have departing from boston today	flights
how many first class [MASK] does delta airlines have	flights
how many first class [MASK] does united have leaving from all airports today	flights
eastern flies from atlanta to denver what [MASK] of aircraft do you use before 6 pm	type
i want to leave before 8 in the morning what [MASK] should i take to atlanta from boston	flight
yes i live in washington and i want to make a trip to san francisco which [MASK] may i use for this trip	airlines
Besides eating good foods , [MASK] else do people do in Miramar ?	what
But since in my country it lasts for minimum 6 years , and I want to go aground the world , [MASK] do you think , should I do it before or after medical school ?	what
If being followed was a certainty , [MASK] did it matter ?	what
Mr Malfoy , what a [MASK] to see you again , said Mr Borgin in a voice as oily as his hair .	pleasure
Honest Guv ' I had both [MASK] tied behind my back .	hands
Sheltered employment all these years , [MASK] d' you expect ?	what
Yes , Arthur , [MASK] , said Mrs Weasley , her eyes flashing .	cars
Other than yourself , which [MASK] have you supported for president in previous campaigns ?	candidates
how many first class [MASK] does delta have today	flights
how many first class [MASK] does united have leaving from all cities today	flights
If the Empire could not stop the Enemy before , what [MASK] did they have now ?	hope
The problem is how [MASK] will it take and how many victims will it call for .	long
From an entrepreneurial perspective , what [MASK] could you invent to support both organic farming and the problems of insects that damage or destroy crops ?	products
