Σ το δεύτερο ημίχρονο , η Ατλέτικο [MASK] δύο τέρματα με τους Όσκαρ ντε Μάρκος ( 71ο λεπτό ) και Ικέρ Μουνιάιν ( 90ο λεπτό ) .	πέτυχε
Ωστόσο , ο Γουέν Ρούνι με πέναλτι [MASK] το σκορ για την Μάντσεστερ .	μείωσε
Ο ποταμός Αχέροντας [MASK] κατά τη μυθολογία το δρόμο μέσω του οποίου ο Άδης μετέφερε τις ψυχές σ το βασίλειό του , σ τη λίμνη Αχερουσία .	αποτελούσε
Σ το Ιράκ , κατά τη διάρκεια συγκρούσεων μεταξύ διαδηλωτών ( μέλη της σουνιτικής μειονότητας του Ιράκ ) και στρατιωτών , πέντε άτομα [MASK] τη ζωή τους , ενώ άλλα 20 σκοτώθηκαν .	έχασαν
Ομάδες του Ερυθρού Σταυρού σ τη Συρία [MASK] την Κυριακή προμήθειες σε περιοχές κοντά σ την γειτονιά Μπάμπα Αμρ της πόλης Χομς , αλλά για τρίτη συνεχόμενη ημέρα τους απαγορεύτηκε η είσοδος σ την συνοικία που ελέγχονταν μέχρι πρόσφατα από τους αντάρτες .	παρέδωσαν
Οι μισοί Γάλλοι [MASK] αυξημένη την τρομοκρατική απειλή	θεωρούν
Επίσης , τα κατώτερα κοινωνικά στρώματα [MASK] μεγαλύτερη ανησυχία από τα ανώτερα κοινωνικά στρώματα » .	εμφανίζουν
Ο Υπουργός Εξωτερικών της Ρωσίας , Σεργκέι Λαβρόφ , [MASK] τις λεπτομέρειες συμφωνίας που θα επιτρέπει σ τις ΗΠΑ και άλλα μέλη του ΝΑΤΟ να χρησιμοποιούν αεροδρόμιο σ την κεντρική Ρωσία ως κέντρο ανεφοδιασμού των δυνάμεων που βρίσκονται σ το Αφγανιστάν .	επιβεβαίωσε
Κυρία Πρόεδρε , [MASK] αυτή την πρωτοβουλία ως ένα ακόμα μικρό βήμα σ την πορεία προς την εκπλήρωση της εντολής που λάβαμε σ τη Σύνοδο του Τάμπερε να καταστήσουμε την αρχή της αμοιβαίας αναγνώρισης ακρογωνιαίο λίθο της δικαστικής συνεργασίας .	καλωσορίζουμε
Η ΕΕ πρέπει να [MASK] μια συνεργασία σ την έννοια της εκτέλεσης της απόφασης του κράτους έκδοσης , και όχι σ την έννοια της απόφασης να παρέχει ή όχι συνεργασία κατόπιν αιτήσεως .	βασίσει
Η άλλη διεθνής σύμβαση - η Σύμβαση του 1970 - [MASK] 13 αιτίες για τις οποίες μια αίτηση μπορεί να απορριφθεί , κι έτσι μπορούμε να καταλάβουμε γιατί το σύστημα δεν λειτουργεί αυτή τη στιγμή .	περιλαμβάνει
Η εκπομπή " Μένουμε Ελλάδα " με το Γιώργο Αμυρά και την Ρένια Τσιτσιμπίκου [MASK] το μεσαιωνικό οικισμό σ τη Χώρα της Αλοννήσου , την παλιά πρωτεύουσα του νησιού που σήμερα έχει κηρυχθεί διατηρητέα , περπατάει σ τα στενά σοκάκια ανάμεσα σ τις λιθοσκέπαστες εκκλησίες και θαυμάζει την μοναδική θέα προς τη θάλασσα .	επισκέπτεται
Το γραφικό κυκλαδίτικο νησί της Σίφνου [MASK] 365 εκκλησίες , μία για κάθε ημέρα του χρόνου .	έχει
Τα ερείπια ενός αρχαίου οικισμού που βρίσκονται πίσω από τα σπίτια της παραλίας , το αρχαίο ιερό με τα δύο κτίσματα του 7ου αιώνα π.Χ. καθώς και ο κούρος , ο οποίος βρίσκεται πλέον σ το μουσείο της Κωνσταντινούπολης [MASK] την ύπαρξη και ανάπτυξη της αρχαίας πόλης .	μαρτυρούν
Κύριε Πρόεδρε , δεν [MASK] κανένα σεβασμό προς εκείνους που επιδιώκουν να θυσιάσουν την ζωή των υπολοίπων για να επιτύχουν τους στόχους τους .	τρέφω
Αλλά , από την άλλη πλευρά , [MASK] τον μεγαλύτερο σεβασμό για το δημοκρατικό μας σύστημα και τη δικαιοσύνη και πιστεύω επίσης ότι είναι υποχρέωση του Κοινοβουλίου να τα υπερασπιστούμε με τον ίδιο ενθουσιασμό .	έχω
Κύριε Πρόεδρε , κατά τη διάρκεια των τελευταίων εβδομάδων [MASK] ορισμένα ζητήματα , τα οποία σχετίζονται άμεσα με τον κλάδο των μεταφορών - ακόμα και τα κοινωνικά μέτρα - ενώ και σ την Επιτροπή Περιφερειακής Πολιτικής , Μεταφορών και Τουρισμού εκφράσαμε την άποψη ότι όλα αυτά τα μέτρα - πιστεύω μάλιστα ότι ο χρόνος εργασίας ο οποίος επιτέλους ρυθμίστηκε πλέον είναι ένα σημαντικό κεφάλαιο , το οποίο ολοκληρώθηκε - έχουν νόημα μόνο εάν υπάρχει η ανάλογη βούληση από τα κράτη μέλη , αφενός για την εντατικοποίηση των ελέγχων και αφετέρου για την αναπροσαρμογή των κυρώσεων .	επεξεργασθήκαμε
Πάντως , η Γερουσία [MASK] τις εργασίες της τη Δευτέρα το βράδυ και τα μέλη της Βουλής αναχώρησαν και αυτά από το Καπιτώλιο .	διέκοψε
Ο Ρικ Σαντόρουμ , υποψήφιος για το προεδρικό χρίσμα των Ρεπουμπλικανών , [MASK] μεγάλη νίκη σ την πολιτεία του Κάνσας .	πέτυχε
Με καταμετρημένο ποσοστό μεγαλύτερο του 75% , ο Ρικ Σαντόρουμ [MASK] το 53% των ψήφων , ο Μιτ Ρόμνεϊ έλαβε το 17% , ο Νιουτ Γκίνγκρις το 16% και ο Ρον Πωλ έλαβε το 13% .	συγκέντρωσε
Νωρίτερα , ο Μιτ Ρόμνεϊ [MASK] έξι νίκες σ τις δέκα αναμετρήσεις της Σούπερ Τρίτης .	πέτυχε
Επίσης , ο Μιτ Ρόμνεϊ [MASK] νίκη σ το Γκουάμ και σ τις Βόρειες Μαριάνες , οι οποίες αν και δεν ψηφίζουν σ τις προεδρικές εκλογές στέλνουν εκλέκτορες σ τα κομματικά συνέδρια .	πέτυχε
Η Βόρεια Κορέα [MASK] ασκήσεις με πραγματικά πυρά σε δύο σημεία που βρίσκονται κοντά σε αμφισβητούμενη θαλάσσια περιοχή σ τα σύνορα με τη Νότια Κορέα .	ξεκίνησε
Σύμφωνα με τη Σεούλ , η Πιονγκγιάνγκ είχε [MASK] λίγες ώρες νωρίτερα τις δύο περιοχές και ενημέρωσε τον Υπουργό Άμυνας της Ν. Κορέας .	καθορίσει
" Παρά το γεγονός ότι οι περιοχές που πραγματοποιούνται οι ασκήσεις βρίσκονται βόρεια από τη βόρεια συνοριακή γραμμή , ο στρατός της Ν. Κορέας [MASK] μέτρα ασφαλείας , συμπεριλαμβανομένου του ελέγχου των πολιτικών πλοίων .	λαμβάνει
Σύμφωνα με αξιωματούχους της Ν. Κορέας , η Πιονγκγιάνγκ [MASK] 50 γύρους εκτοξεύσεων , ωστόσο τα πυρά της δεν ξεπέρασαν τη συνοριακή γραμμή .	πραγματοποίησε
Η Βόρεια Κορέα [MASK] παρεμφερείς ασκήσεις τον περασμένο μήνα , και κάποια από τα πυρά της έφθασαν σ τα ύδατα της Ν. Κορέας , προκαλώντας απάντηση από πλευράς Ν. Κορέας .	πραγματοποίησε
Η Βόρεια Κορέα [MASK] τη βόρεια συνοριακή γραμμή , λέγοντας ότι έχει επιβληθεί μονομερώς και πρέπει να μεταφερθεί νοτιότερα .	αμφισβητεί
Κατά την περίοδο της Τουρκοκρατίας [MASK] καταφύγιο των κατοίκων .	αποτέλεσε
Σε πολλούς τομείς το [MASK] αυτό .	πέτυχαν
Εξ ονόματος της Ομάδας ΕΛΚ-ΕΔ [MASK] τον Udo Bullmann τόσο για την εργασία του όσο και για την ικανότητά του να διεξάγει διάλογο και να βρίσκει συμβιβαστικές λύσεις .	συγχαίρω
Η μελέτη της Πίζας [MASK] σ τη Γερμανία ένα ευεργετικό σοκ .	προκάλεσε
Η εκπαίδευση και η μόρφωση [MASK] επιτέλους προτεραιότητα σ την πολιτική .	απέκτησαν
Ο κοινωνικός διάλογος πρέπει να [MASK] τη χρησιμότητά του ειδικά σε δύσκολες περιόδους .	αποδείξει
Μόνο υπό την απειλή της προειδοποιητικής επιστολής [MASK] τώρα σ τη Γερμανία τουλάχιστον ενδείξεις ότι θα ακολουθηθεί με συνέπεια μια πολιτική λιτότητας .	έχουμε
Κύριε Πρόεδρε , κύριε Πρόεδρε του Συμβουλίου , κυρίες και κύριοι , η Επιτροπή [MASK] τη σημερινή συζήτηση σχετικά με τα δημοκρατικά δικαιώματα σ την Τουρκία .	επικροτεί
Ειδικότερα , η Τουρκία έχει [MASK] ένα εθνικό πρόγραμμα για την υιοθέτηση του κεκτημένου προκειμένου να εκπληρώσει όλες τις προτεραιότητες της εταιρικής σχέσης .	υιοθετήσει
Το Ευρωπαϊκό Συμβούλιο του Λάκεν [MASK] τις προσπάθειες της Τουρκίας και διαπίστωσε ότι η χώρα έχει έρθει πιο κοντά σ τον στόχο της ένταξής της σ την Ευρωπαϊκή Ένωση .	αξιολόγησε
Ωστόσο , η Ευρωπαϊκή Ένωση [MASK] από την Τουρκία τη συνεπή συνέχιση της μεταρρυθμιστικής διαδικασίας .	αναμένει
Επί του παρόντος η Τουρκία δεν [MASK] ακόμη τα πολιτικά κριτήρια της Κοπεγχάγης .	πληροί
Σ τις συνομιλίες που είχα σ την Αγκυρα την περασμένη εβδομάδα [MASK] με έμφαση την τουρκική κυβέρνηση να συνεχίσει με αποφασιστικότητα την πορεία των πολιτικών και οικονομικών μεταρρυθμίσεών της .	ενεθάρρυνα
Οι συνομιλητές μου , προερχόμενοι από όλα τα κόμματα του παρόντος κυβερνητικού συνασπισμού , [MASK] τη βούλησή τους να προβούν σε περαιτέρω μεταρρυθμίσεις , καθώς και την επιθυμία τους να προσεγγίσει η Τουρκία περαιτέρω την Ευρωπαϊκή Ένωση .	επιβεβαίωσαν
Βάσει της περσινής αναθεώρησης του συντάγματος , η Τουρκία [MASK] κατά τον τρέχοντα μήνα μια περιορισμένη δέσμη μέτρων για την υλοποίηση της εν λόγω αναθεώρησης .	θέσπισε
Σ τα σχετικά άρθρα του νέου κειμένου [MASK] λιγοστές μόνο βελτιώσεις σε σύγκριση με τις ισχύουσες διατάξεις σ τον τομέα της ελευθερίας σκέψης .	διακρίνουμε
Σε τελική ανάλυση , δεν πρέπει να [MASK] την κατάσταση των ανθρωπίνων δικαιωμάτων σ την Τουρκία με κριτήριο αυτά που γράφονται σ το χαρτί αλλά με κριτήριο αυτά που συμβαίνουν καθημερινά σ την πράξη .	κρίνουμε
Παράλληλα με το Ευρωπαϊκό Κοινοβούλιο [MASK] και η Επιτροπή τις εξελίξεις σε σχέση με τη δίκη που διεξάγεται κατά του κόμματος HADEP ενώπιον του τουρκικού συνταγματικού δικαστηρίου .	παρακολουθεί
Εκπρόσωποι της Επιτροπής [MASK] προσπάθειες ώστε να μπορούν να είναι παρόντες εκεί .	καταβάλλουν
Φυσικά , η Επιτροπή [MASK] την προκείμενη περίπτωση βάσει των πολιτικών κριτηρίων της Κοπεγχάγης .	κρίνει
Τον περασμένο χρόνο η Τουρκία [MASK] το σύνταγμά της προκειμένου να ενισχύσει τα ανθρώπινα δικαιώματα σ την Τουρκία .	αναθεώρησε
Ωστόσο , το τουρκικό κοινοβούλιο δεν [MASK] τη νομική βάση για την απαγόρευση πολιτικών κομμάτων .	έθιξε
Για τον λόγο αυτό [MASK] της ευκαιρίας να ενθαρρύνω εκ νέου την Τουρκία να ενισχύσει τα δημοκρατικά δικαιώματα σ τη χώρα καθώς και να δρομολογήσει και να ολοκληρώσει τις σχετικές νομοθετικές πρωτοβουλίες .	δράττομαι
Ο σεβασμός των ανθρωπίνων δικαιωμάτων σ την πράξη [MASK] οπωσδήποτε καθοριστική σημασία , όπως σημασία έχει να διασφαλίσει η Τουρκία σ την καθημερινή κοινωνική συνύπαρξη του πληθυσμού της τα κριτήρια μιας δημοκρατικής και πλουραλιστικής κοινωνίας .	έχει
Η πλειοψηφία των αμερικανών [MASK] απόσυρση από Αφγανιστάν	θέλει
Αναλυτικά , το 54% των αμερικανών [MASK] την απόσυρση των αμερικανικών στρατευμάτων από το Αφγανιστάν , ακόμα και εάν ο αφγανικός στρατός δεν είναι έτοιμος να αναλάβει τις ευθύνες του .	επιθυμεί
Επίσης η Δυτικοαφρικανική Ένωση [MASK] άλλους δύο χιλιάδες στρατιώτες , σ το πλαίσιο δύναμης που έχει εξουσιοδοτηθεί από τα Ηνωμένα Έθνη .	στέλνει
Συγκεκριμένα , η FSA [MASK] την απόσυρση τροφίμων που περιέχουν την χημική ουσία Sudan-1 , μεταξύ των οποίων και η δημοφιλής σάλτσα Γουόρτσεστερ .	ζήτησε
Σ το μεταξύ , οι υπηρεσίες του υπουργείου Υγείας της Κύπρου [MASK] σε δείγματα μελιού ελληνικής προέλευσης υπολείμματα της ουσίας 1,4 διχλωροβενζόλιο και συνέστησαν σ τους καταναλωτές να αποφεύγουν συγκεκριμένες παρτίδες του μελιού " Attiki " με ημερομηνία ανάλωσης πριν τον Ιανουάριο_του_2008 .	εντόπισαν
Η πλήρης λίστα των προϊόντων που δημοσιοποίησε την Παρασκευή η Υπηρεσία Προδιαγραφών Τροφίμων ( FSA ) [MASK] σάλτσες , σούπες , πίτσες και προμαγειρεμένα φαγητά .	περιλαμβάνει
Έξι « tour operators » της Γερμανίας [MASK] καμπάνια υπέρ της Ελλάδος	ξεκίνησαν
Σ τη Λιθουανία , η χορήγηση τροφίμων από 30000 άτομα που ήταν το 2006 [MASK] τα 100000 άτομα το 2012 .	έφτασε
Όπως ανέφερε η Ανίτα Ούντερλιν , Επικεφαλής των Υπηρεσιών του Ερυθρού Σταυρού για την Ευρώπη , " ο αυξανόμενος αριθμός ατόμων που ζητούν βοήθεια [MASK] το μέγεθος της οικονομικής κρίσης " .	δείχνει
Ασφαλώς , η συνόψιση των μέχρι τώρα οδηγιών , η εναρμόνιση και ο εκσυγχρονισμός τους [MASK] ένα πολύ ουσιαστικό βήμα .	αποτελούν
Η πρόταση της Επιτροπής [MASK] δραστικά τα περιθώρια που υπήρχαν μέχρι τώρα και αποτελούν ισχύον δίκαιο .	περιορίζει
Επίσης , το Ευρωπαϊκό Δικαστήριο [MASK] πολύ καλές και υπεύθυνες ερμηνείες του υφισταμένου δικαίου με αποφάσεις που χαράζουν νέες κατευθύνσεις , ειδικά και τώρα με την τελική εισήγηση ως προς την υπόθεση του Ελσίνκι .	έδωσε
Εμείς σ την Αυστρία το [MASK] αυτό " η αρχή του Florian " :	αποκαλούμε
Ειδικά αυτή η πτυχή των ευρωπαϊκών δήμων και κοινοτήτων [MASK] την πλειοψηφία της Ομάδας μας σ το αίτημα αύξησης των τιμών κατωφλίων .	οδηγεί
Σ τις τροπολογίες μου 134 και 110 [MASK] διάφορες ψηφοφορίες κατά τμήματα .	συμπεριλάβαμε
Τα αποτελέσματα θα [MASK] δισεκατομμύρια ανθρώπους σε ολόκληρο τον κόσμο .	ωφελήσουν
Πριν τις ευρωπαϊκές κυρώσεις οι ΗΠΑ είχαν [MASK] τα ονόματα 7 ρώσων αξιωματούχων και 17 εταιρειών εναντίον των οποίων επιβλήθηκαν κυρώσεις τη Δευτέρα .	ανακοινώσει
Το Τόκιο δεν [MASK] σ τη δημοσιότητα τα ονόματα των προσώπων που θα επηρεαστούν .	έδωσε
Η Ρωσία , μαζί με την Κίνα , έχει [MASK] σ το παρελθόν δύο σχέδια της Δύσης για τη Συρία .	αρνηθεί
Οι μη κυβερνητικές οργανώσεις που λειτουργούν σ την Ερυθραία μας [MASK] καταστάσεις εξαιρετικής σοβαρότητας ·	αναφέρουν
Από τους 250 κατοίκους του χωριού αυτού οι 39 [MASK] τη ζωή τους , σύμφωνα με τους πυροσβέστες .	έχασαν
Σ την ηρεμία της νύχτας , ο Εγκέλαδος [MASK] το θάνατο και τον πανικό , σείοντας άγρια την επαρχία του Αμπρούτζο , αλλά και ολόκληρη τη χώρα .	σκόρπισε
Ο χειρότερος σεισμός των τελευταίων 30 ετών σ την Ιταλία [MASK] σεισμόπληκτους σε 26 πόλεις και χωριά , εκατοντάδες τραυματίες σ το νοσοκομείο της πόλης , που και αυτό έχει υποστεί ζημιές και κάπου 15.000 « κόκκινα » κτίρια .	αφήνει
Για το λόγο αυτό , [MASK] την παρούσα έκθεση σε δύο μόνον βασικά σημεία : σ τα κενά της ισχύουσας νομοθεσίας και σ τους τομείς όπου η περαιτέρω προσπάθεια μπορεί να αποφέρει πραγματική προστιθέμενη αξία .	επικέντρωσα
Καταρχάς , η εισαγωγή των αξιολογήσεων των επιπτώσεων για την υγεία σε όλα τα μείζονα κοινοτικά έργα και δράσεις σ τον τομέα των μεταφορών [MASK] την πλέον σημαντική μεμονωμένη πρωτοβουλία , η οποία θα μπορούσε να συμβάλει σ την ολοκλήρωση των πολιτικών μεταφορών και υγείας , και σ την ελαχιστοποίηση των αρνητικών επιπτώσεων των μεταφορών σ την υγεία .	συνιστά
Το δεύτερο θέμα σ το οποίο επικεντρώθηκα [MASK] την προώθηση της ποδηλασίας και του βαδίσματος σ την πολιτική μεταφορών της ΕΕ , σ το πλαίσιο της επικουρικότητας .	αφορά
Προκειμένου να καταδείξει τους λόγους για τους οποίους η ανάληψη δράσης καθίσταται επείγουσα και επιτακτική , η έκθεσή μου [MASK] ορισμένες από τις βασικές αρνητικές επιδράσεις σ την υγεία λόγω της αύξησης των μεταφορών .	συνοψίζει
Μόλις πριν από μερικές εβδομάδες , επιστήμονες από την Καλιφόρνια [MASK] στοιχεία σύμφωνα με τα οποία τα καυσαέρια των αυτοκινήτων μπορούν πράγματι να προκαλέσουν άσθμα , και όχι απλώς να επιδεινώσουν την κατάσταση των ήδη πασχόντων .	δημοσιοποίησαν
Έτσι δεδομένου ότι εστιάστηκα σε δύο τομείς προτεραιότητας , θα πρέπει να [MASK] τη διαδικασία που ακολουθήθηκε για τον εντοπισμό των τομέων αυτών .	εξηγήσω
Για το λόγο αυτό , θα [MASK] μια προφορική τροπολογία , την οποία από όσο γνωρίζω εγκρίνει η Ομάδα του Κόμματος των Ευρωπαίων Σοσιαλιστών , να μεταβληθεί το 2004 σε 2003 .	υποβάλω
Όσον αφορά την έκθεση του κ. Grosch , [MASK] θετική την οδηγία , γιατί αναγνωρίζει ότι μας δίνεται τώρα η δυνατότητα να βελτιώσουμε την οδική ασφάλεια .	θεωρώ
Οι συνθήκες εργασίας των οδηγών [MASK] άμεσες επιπτώσεις τόσο για την οικονομία όσο και για την ασφάλεια .	έχουν
Κατά συνέπεια , η Ομάδα μου θα [MASK] τις περισσότερες τροπολογίες που υποστηρίζουν την αρχή αυτή και θα υποστηρίξει τη θέση του εισηγητή .	καταψηφίσει
Κύριε Πρόεδρε , κύριε Προεδρεύοντα του Συμβουλίου , κύριε Πρόεδρε της Επιτροπής , κυρίες και κύριοι , καταρχάς , [MASK] την ισπανική Προεδρία για την ευθύτητα με την οποία παρουσιάζεται εδώ , ακολουθώντας κάτι που αποτελεί πλέον έθιμο , και επισημαίνω ότι έχουμε περάσει τον ισημερινό της νομοθετικής περιόδου με μια σαφώς συντηρητική στροφή σ το Συμβούλιο , το οποίο , κύριε Πρόεδρε , ανακόπτεται από την ιδιότητά σας ως Προέδρου της ΧΔΔ - της κεντρώας δημοκρατικής διεθνούς , για εσάς , χριστιανοδημοκρατικής διεθνούς για τον κ. Poettering ·	ευχαριστώ
Το πρόγραμμα της Προεδρίας σας [MASK] τη συνηθισμένη γραμμή της εξαμηνιαίας προσέγγισης του Συμβουλίου , να στηρίζεται σε όλες τις δυνατές επιτυχίες .	ακολουθεί
Πρέπει να το [MASK] αυτό , διότι πάντα κατακρίνουμε την απόστασή μας από τους πολίτες , και σ' αυτή την περίπτωση , κυρίες και κύριοι , την πρώτη Ιανουαρίου εκείνοι μας προσπέρασαν .	αναγνωρίσουμε
Η πρόκληση τώρα είναι να [MASK] μία Οικονομική Ένωση η οποία θα ανταποκρίνεται σ την Νομισματική Ένωση - όπως επεσήμανε ο Πρόεδρος της Επιτροπής - και επίσης να αναπτύξουμε την στρατηγική της Λισαβόνας , η οποία κατά τη γνώμη μας είναι αειφόρος ανάπτυξη , περισσότερη κοινωνική συνοχή , περισσότερη πλήρης απασχόληση , περισσότερος ανταγωνισμός .	δημιουργήσουμε
Σ' αυτό το σημείο , κύριε Προεδρεύοντα του Συμβουλίου , σας [MASK] την προσοχή σ το ψήφισμα του Ευρωπαϊκού Κοινοβουλίου σχετικά με τις υπηρεσίες γενικού ενδιαφέροντος , που ήταν πολύ σαφές .	εφιστώ
Με την Αργεντινή οι Ευρωπαίοι [MASK] ιστορικούς δεσμούς και χρέη έναντι όσων κατέφυγαν εκεί για να γλιτώσουν από την πείνα ή την καταπίεση .	έχουμε
Κυρίες και κύριοι , δεν [MASK] τη Συνέλευση ως μια μάχη μεταξύ κομμάτων και εδώ πρέπει να επισημάνω ότι ο κ. Berlusconi , σ τη " Le Monde " της 12ης_Ιανουαρίου , είπε ότι εμείς είμαστε υπέρ του συγκεντρωτισμού των πάντων .	αντιλαμβανόμαστε
Νωρίτερα , το Υπουργείο Αμύνης της Ιαπωνίας [MASK] την Κίνα για αποστολή φρεγάτας σ τα αμφιλεγόμενα νησιά , η οποία , σ τις 30 Ιανουαρίου , είχε βάλει σ το στόχαστρο του ραντάρ της ιαπωνικό πολεμικό πλοίο .	κατηγόρησε
Η ανακοίνωση της Επιτροπής προς το Ευρωπαϊκό Συμβούλιο της Βαρκελώνης [MASK] τη σταθερή προσήλωση σ το σύμφωνο ανάπτυξης και σταθερότητας , η οποία θα βοηθήσει σ τη δημιουργία κλίματος εμπιστοσύνης .	διακηρύσσει
Η καταψήφιση της οδηγίας για τις προσφορές εξαγοράς [MASK] σημαντική οπισθοδρόμηση για τον ανταγωνισμό σ την Ένωση και προκαλώ τις υπόλοιπες πολιτικές ομάδες και το Συμβούλιο να συμπαραταχθούν μαζί μας σ την ταχεία προώθηση της νέας πρότασης της Επιτροπής σ το πλαίσιο μιας ταχείας διαδικασίας προκειμένου να μπορέσουμε να την εντάξουμε σ τη νομοθεσία μέχρι το τέλος αυτού του έτους .	συνιστά
Το Ευρωπαϊκό Κοινοβούλιο έχει [MASK] τη δουλειά του .	κάνει
Εάν επιθυμούμε να γεφυρώσουμε το χάσμα σ τον τομέα της καινοτομίας μεταξύ της Ευρώπης και των Ηνωμένων Πολιτειών , [MASK] ευκολότερη , φθηνότερη και ταχύτερη πανευρωπαϊκή προστασία της ευρεσιτεχνίας .	χρειαζόμαστε
Τέλος , ο έλεγχος προόδου μας θα [MASK] έναν μαθητή με μειωμένες φιλοδοξίες .	φανέρωνε
Η διαδικασία οικονομικών μεταρρυθμίσεων δεν [MASK] αυτοσκοπό .	αποτελεί
Σύμφωνα με τις επίσημες δηλώσεις , κανένα πρόβλημα δεν θα [MASK] τη θριαμβευτική έλευση του ευρώ .	κηλίδωνε
Τα μηχανήματα αυτόματης συναλλαγής δεν [MASK] χαρτονομίσματα των είκοσι ευρώ , ούτε δέχονται ευρώ που εκδόθηκαν σε άλλες χώρες και οι παραχαράκτες ευνοούνται καθώς κανείς δεν είναι σε θέση να αναγνωρίζει τα νέα χαρτονομίσματα .	δίνουν
οι Ευρωπαίοι δεν [MASK] το ευρώ με ενθουσιασμό ·	χρησιμοποιούν
Συνεπώς , το ευρώ δεν [MASK] κανένα πλεονέκτημα σ την καθημερινή ζωή .	προσφέρει
Σήμερα , όλοι οι Ευρωπαίοι [MASK] ένα ξένο νόμισμα .	διαθέτουν
Έτσι , σ το όνομα της αυτοδιάθεσης των λαών , εμείς [MASK] το δικαίωμα των λαών να χρησιμοποιήσουν ξανά κάποια στιγμή σ το μέλλον το εθνικό τους νόμισμα όπως έπραξαν πριν από λίγο καιρό οι λαοί που απελευθερώθηκαν από τον σοβιετικό ομοσπονδιακό ζυγό .	υποστηρίζουμε
Ο δεύτερος τομέας , που αφορά τις περιβαλλοντικές ανησυχίες , [MASK] ένα άλλο πολύ σημαντικό ζήτημα .	αποτελεί
Το τρίτο μου σημείο [MASK] τις κοινωνικές υποχρεώσεις , και συγκεκριμένα συμφωνώ πλήρως με τους βουλευτές που είπαν ότι πρέπει να υπάρξει κάποια κοινωνική ανταπόδοση για την αναθέτουσα αρχή και την περιοχή της από την ανάθεση της σύμβασης .	αφορά
Το τελευταίο μου σημείο [MASK] τα κριτήρια ποιοτικής επιλογής .	αφορά
Επομένως , η πρόταση αυτή [MASK] αποκλειστικά τους οδηγούς οι οποίοι απασχολούνται σε επιχειρήσεις της ΕΕ και οδηγούν φορτηγά οχήματα αυτών των επιχειρήσεων .	αφορά
Για τον λόγο αυτόν το Κοινοβούλιο [MASK] διετή αναβολή για την εφαρμογή του κανονισμού σε οδηγούς από χώρες μέλη .	προτείνει
Από τις τροπολογίες του Κοινοβουλίου , το Συμβούλιο [MASK] άμεσα δεκτή μόνο την τροπολογία η οποία ζητά να περιληφθεί ο αριθμός της άδειας οδήγησης και της κοινωνικής ασφάλισης .	έκανε
Εξάλλου , το Συμβούλιο [MASK] μία ερμηνεία του ποσοστού αξιολογήσεων ( 20% ) των εκδοθεισών βεβαιώσεων .	πρότεινε
Και τα δύο όργανα [MASK] τον επείγοντα χαρακτήρα και την ουσία του προβλήματος : τους οδηγούς από χώρες εκτός ΕΕ .	αναγνωρίζουν
Εάν αποφασίσουμε ότι ναι μεν θα πρέπει να εκπαιδεύεται κάθε οδηγός , όμως αυτό θα πρέπει να γίνεται σύμφωνα με τις εθνικές προδιαγραφές , θα [MASK] τον λεγόμενο " εκπαιδευτικό τουρισμό " , ακριβώς αυτό που δεν θέλουμε να συμβεί .	ενισχύσουμε
Δεν πρέπει να [MASK] τους κινδύνους που δημιούργησε η συγκεκριμένη ενέργεια , καθώς , εάν είχε επιτύχει τον στόχο της δολοφονίας των υπουργών της κυβέρνησης και των ηγετών της αντιπολίτευσης που ήταν παρόντες σ τον χώρο , θα είχε σημάνει την έναρξη πολέμου μεταξύ της Ινδίας και του Πακιστάν , χωρών που είναι και οι δυο πυρηνικές δυνάμεις και διαθέτουν , επίσης , τεράστιες συμβατικές χερσαίες δυνάμεις - αν και η Ινδία έχει τουλάχιστον διακηρύξει πολιτική μη πρώτης χρήσης του πυρηνικού της οπλοστασίου , αντίθετα από το Πακιστάν .	υποτιμούμε
Παρ' όλα αυτά , [MASK] τη μεταστροφή του προέδρου Μουσάραφ και την υποστήριξή του προς τις Ηνωμένες Πολιτείες σ τον πόλεμο που έχουν εξαπολύσει εναντίον της τρομοκρατίας , ο οποίος οδήγησε σ την ανατροπή του καθεστώτος των Ταλιμπάν και σ την εξάρθρωση του δικτύου της Αλ Κάιντα σ το Αφγανιστάν , αν και το ενλόγω καθεστώς ήταν σε μεγάλο βαθμό δημιούργημα των μυστικών υπηρεσιών του Πακιστάν .	χαιρετίζω
Κατά τη διάρκεια του πολέμου του Αφγανιστάν τη δεκαετία του ' 80 , εμείς , σ τη Δύση , [MASK] τον ισλαμικό φονταμενταλισμό προκειμένου να καταπολεμήσουμε την εξάπλωση του κομμουνισμού .	υποστηρίξαμε
Η Αμερική , δυστυχώς , [MASK] το τίμημα σ τις 11_Σεπτεμβρίου .	πλήρωσε
Σ τις δύο γνωμοδοτήσεις των οποίων υπήρξα συντάκτης εξ ονόματος της Επιτροπής Περιβάλλοντος Δημόσιας Υγείας και Πολιτικής των Καταναλωτών , [MASK] ρητή αναφορά σ τη δυνατότητα να λαμβάνονται υπόψη οι περιβαλλοντικές πτυχές κατά τις δημόσιες προμήθειες .	κάναμε
Με χαρά επίσης [MASK] το γεγονός ότι οι περισσότερες από τις τροπολογίες της Επιτροπής Περιβάλλοντος υιοθετήθηκαν από την αρμόδια επιτροπή .	σημείωσα
Σύμφωνα με την έκθεση , οι επιπτώσεις της οικονομικής κρίσης και η έξαρση του λαϊκισμού [MASK] τα κύρια αίτια της φθοράς που υπέστη η ελευθερία του τύπου σ την Ελλάδα .	αποτελούν
Σε αυτή τη συζήτηση δεν [MASK] τα άτομα που παρέχουν δημόσιες υπηρεσίες σ την Ευρωπαϊκή Ένωση ως αποτέλεσμα της τεράστιας προόδου που έχει σημειωθεί σ το άνοιγμα της ανάθεσης δημοσίων συμβάσεων σε όλη την Ευρωπαϊκή Ένωση .	ακούσαμε
Μέχρι στιγμής , δεν [MASK] τίποτα σήμερα το απόγευμα για τα άτομα που κινούν την οικονομία επειδή αποκτούν ανοικτή πρόσβαση σε διαγωνισμούς , με φθηνό και ευχερή τρόπο μέσω της ηλεκτρονικής οδού .	ακούσαμε
Πριν λίγες εβδομάδες , [MASK] μία από αυτές τις εταιρείες σ την εκλογική μου περιφέρεια .	επισκέφθηκα
Η εταιρεία αυτή δεν [MASK] επί του παρόντος εξαγωγικές φιλοδοξίες , αλλά η Επίσημη Εφημερίδα της προσφέρει φθηνή , εύκολη πρόσβαση σε πελάτες δημόσιες αρχές σε μια τυποποιημένη μορφή .	έχει
Η εταιρεία αυτή σ τη Black Country σ το Ηνωμένο Βασίλειο [MASK] 80 άτομα , δηλαδή 80 θέσεις εργασίες για τις οποίες υπάρχει μεγάλη ανάγκη , και συμμορφώνεται με όλες τις κοινωνικές προδιαγραφές της νομοθεσίας του Ηνωμένου Βασιλείου .	απασχολεί
Γιατί να πρέπει να [MASK] και κάτι άλλο ;	κάνει
Αν οι εταιρείες συμμορφωθούν με αυτό , πρέπει να [MASK] το δικαίωμα να υποβάλλουν προσφορές για συμβάσεις .	έχουν
Επειδή απλά το θεωρούν δύσκολο , επειδή πιστεύουν ότι τους κοστίζει χρήματα - πιθανόν επειδή δεν θέλουν να συμμορφωθούν με όλες τις απαιτήσεις - [MASK] περισσότερη διακριτικότητα ώστε να μην συνάπτονται οι συμβάσεις σε ανοικτή βάση .	θέλουν
Η αλλαγή αυτής της προσέγγισης θα [MASK] ή τουλάχιστον θα παρακώλυε σημαντικά ιδίως τη χρήση των συμβάσεων " με το κλειδί σ το χέρι " , των κοινοπραξιών δημοσίου/ιδιωτικού τομέα , των παραχωρήσεων έργων και του ανταγωνιστικού διαλόγου .	απέτρεπε
Η Επιτροπή θα [MASK] , συνεπώς , την απόφαση του Δικαστηρίου και θα επανεξετάσει την άποψή της υπό το φως της απόφασης , εάν δε χρειαστεί , θα εξετάσει το ενδεχόμενο αναθεώρησης της άποψής της σχετικά με τις τροπολογίες του Ευρωπαϊκού Κοινοβουλίου .	περιμένει
Η διπλή ήττα του Μιτ Ρόμνεϊ σ τις νότιες αυτές πολιτείες [MASK] πλήγμα σ τις προσπάθειες του να κερδίσει την υποστήριξη των υπερσυντηρητικών Ρεπουμπλικανών που μέχρι τώρα υποστηρίζουν τον Ρικ Σαντόρουμ .	αποτελεί
Σ το χωριό Yangji , σ την επαρχία Κουανγκτόνγκ σ την Κίνα οι εργολάβοι οικοδομών [MASK] ένα ποτάμι για να αναγκάσουν τους κατοίκους να εγκαταλείψουν τα σπίτια τους .	δημιούργησαν
Ο Σενούντα Γ' [MASK] πολλά προβλήματα υγείας , ενώ αναγκάστηκε αρκετές φορές να μεταβεί σ το εξωτερικό προκειμένου να επιβληθεί σε διάφορες επεμβάσεις , καθώς είχε προβλήματα σ το συκώτι και σ τους πνεύμονες .	αντιμετώπιζε
Το πρόγραμμα ΣΩΚΡΑΤΗΣ [MASK] υπόψη την ιδέα της δια βίου εκπαίδευσης και υποστηρίζει την κινητικότητα τόσο των διδασκόντων όσο και των διδασκομένων σε όλες τις φάσεις της εκπαίδευσης .	λαμβάνει
Το COMENIUS , το οποίο προωθεί τα σχολεία , [MASK] μάλιστα 15.000 σχολεία με περισσότερους από 2 εκατομμύρια μαθητές .	ενισχύει
Πρώτον : η Επιτροπή πρέπει να [MASK] και να επιταχύνει περαιτέρω ιδίως τη συνεργασία με τα εθνικά γραφεία .	βελτιώσει
Εδώ το σύστημα ΣΥΜΜΕΤΡΙΑ που ανέπτυξε η Επιτροπή θα [MASK] σημαντικά τη ροή πληροφοριών από και προς τα εθνικά γραφεία .	βελτιώσει
Η θυσία των κοινοτικών στόχων της εκπαίδευσης σ το βωμό της βραχυπρόθεσμης διακρατικής συνεργασίας θα [MASK] τεράστια οπισθοδρόμηση .	αποτελούσε
Τέλος , θα πρέπει να [MASK] δύο ακόμη σημεία .	προσέξουμε
Οι συμφωνίες εταιρικής σχέσης και συνεργασίας που έχουμε συνάψει με καθεμία από τις τρεις χώρες [MASK] μια ενιαία βάση για τη συνεργασία σε ένα ευρύ φάσμα πεδίων , από τον πολιτικό διάλογο , το εμπόριο και τις επενδύσεις μέχρι τις σχέσεις με την κοινωνία των πολιτών .	παρέχουν
Η εκτέλεση αυτών των συμφωνιών , οι οποίες τέθηκαν σε ισχύ το 1999 , [MASK] σήμερα νέα ώθηση .	λαμβάνει
Η Ευρωπαϊκή Ένωση έχει [MASK] γύρω σ το ένα δισεκατομμύριο ευρώ από το 1991 , έτος κατά το οποίο οι χώρες αυτές απέκτησαν την ανεξαρτησία τους .	χορηγήσει
Πέρυσι , η Ευρωπαϊκή Ένωση [MASK] σ την περιοχή ένα σαφές σήμα ότι επιθυμεί να βελτιώσει τη συμβολή της σ την πρόληψη και τη διευθέτηση των συγκρούσεων και σ την αποκατάσταση μετά τις συγκρούσεις .	έστειλε
Τον Φεβρουάριο_του_2001 η πρώτη επίσκεψη των υπουργών της τρόικας της Ένωσης σ την περιφέρεια [MASK] αυτό το μήνυμα , το οποίο επιβεβαιώθηκε αργότερα σ τα συμπεράσματα του Συμβουλίου Γενικών Υποθέσεων της 26ης_Φεβρουαρίου .	εξέπεμψε
Σε μία κοινή δήλωση που υιοθετήθηκε σ τις συνεδριάσεις της Επιτροπής Συνεργασίας πέρυσι τον Οκτώβριο , οι τρεις χώρες εταίροι [MASK] ρητώς τη χαρά τους για τις προθέσεις της Ένωσης .	εξέφρασαν
Ο κ. Gahrton [MASK] την προσοχή μας σε ορισμένα από τα μέσα που έχουμε χρησιμοποιήσει σε άλλα μέρη και συνιστά να τα εφαρμόσουμε σ τον Νότιο Καύκασο : κοινή στρατηγική , σύμφωνο σταθερότητας , ειδικό απεσταλμένο και άλλα .	εφιστά
Κύριε Πρόεδρε , η ομιλία σας σήμερα [MASK] την αξία του ανοιχτού εκλογικού αγώνα .	δείχνει
Οι πολιτικοί διορισμοί πρέπει να [MASK] ιστορία του παρελθόντος .	αποτελέσουν
Όλοι οι βουλευτές πρέπει να [MASK] δικαίωμα να μιλήσουν τουλάχιστον τρεις φορές τον χρόνο .	έχουν
Τα ανεξάρτητα μέλη πρέπει να [MASK] δικές τους σχετικές δυνατότητες και πρέπει εμείς οι ίδιοι να καταργήσουμε κάθε μορφής διακρίσεις αντί να διακινδυνεύουμε να προκύψει νέα δίκη .	αποκτήσουν
Σ τη συνέλευση πρέπει η πλειοψηφία όσο και η μειοψηφία να [MASK] την ίδια πρόσβαση σ την εγκεκριμένη βοήθεια και σ τη δυνατότητα υποβολής προτάσεων και προώθησής τους .	έχουν
Το κίνημα της Ευρώπης και οι φεντεραλιστές δεν [MASK] αποκλειστικό δικαίωμα να οργανώνουν τη συζήτηση με την κοινωνία των πολιτών με χρήματα του Κοινοβουλίου .	έχουν
Οι τεχνολογικές εξελίξεις , αλλά και οι αυστηρότερες απαιτήσεις ως προς το περιβάλλον και την ασφάλεια , [MASK] κατά τη γνώμη μας επαρκή επιχειρήματα για να προβληθεί το αίτημα όχι μόνο να βελτιωθεί η κατάρτιση των οδηγών αλλά και να συνεχίζεται με τακτική συνεχή κατάρτιση .	συνιστούν
Από τη μία [MASK] ένα είδος γέφυρας προς την άδεια οδήγησης , διότι γνωρίζουμε ότι σε πολλά κράτη μέλη υπάρχουν ήδη συγκεκριμένες προϋποθέσεις για τη χορήγηση άδειας οδήγησης που ταυτίζονται με τα προτεινόμενα εδώ για την κατάρτιση .	δημιουργήσαμε
Κάθε οδηγία , όσο καλή κι αν είναι , [MASK] αξία μόνο εάν ελέγχεται σε τακτά διαστήματα η εφαρμογή της , και μάλιστα με τον ίδιο τρόπο σε όλα τα κράτη μέλη .	έχει
Οι ένοπλοι της Αλ Κάιντα [MASK] τον έλεγχο της Ζίνζιμπαρ τον περασμένο Μάιο , ενώ οι κυβερνητικές δυνάμεις ήταν απασχολημένες με την καταστολή των διαδηλώσεων που πραγματοποιούνταν κατά της αυταρχικής ηγεσίας του τότε Προέδρου Αλί Αμπντουλάχ Σαλέχ .	ανέλαβαν
Κύριε Πρόεδρε , αξιότιμοι βουλευτές , αξιότιμε κύριε εισηγητή , η διαδικασία χορήγησης απαλλαγής για το 1999 [MASK] πραγματικά τη σφραγίδα του εισηγητή .	φέρει
Ούτε εγώ δεν [MASK] τέτοιο αντίτυπο από τον κ. van Buitenen .	έλαβα
Μόλις διατυπωθούν κατηγορίες ότι κάτι δεν εκτελέστηκε σωστά , [MASK] τις εν λόγω κατηγορίες και εάν τίθεται θέμα απάτης τις εξετάζει η OLAF .	εξετάζουμε
Ο Αναπληρωτής Υπουργός Οικονομικών της Ελλάδος , Χρήστος Σταϊκούρας , [MASK] για διαβούλευση νομοσχέδιο σ το οποίο προβλέπεται αυτοματοποιημένο σύστημα για την παραγραφή υπέρ του ελληνικού Δημοσίου των αδρανών καταθέσεων με την παρέλευση της 20ετίας .	έδωσε
Η Υπηρεσία των Ηνωμένων Εθνών για την αποστολή βοήθειας σ το Αφγανιστάν και η αντίστοιχη υπηρεσία για την προώθηση των δικαιωμάτων των γυναικών , [MASK] την Τετάρτη την κυβέρνηση του Αφγανιστάν να εφαρμόσει σ την ολότητά της και άμεσα την νομοθεσία για τον τερματισμό της βίας κατά των γυναικών .	προέτρεψαν
Το παράδειγμα που ανέφερε μόλις ο κ. Bolkestein [MASK] βέβαια ένα κατάφωρο , ίσως μάλιστα και εξαιρετικό , παράδειγμα των καταχρήσεων που γίνονται σ τον τομέα των μεταφορών .	αποτελεί
Κατά τα προηγούμενα έτη [MASK] πολλά ανάλογα παραδείγματα , σχεδόν της ίδιας κλίμακας με το παράδειγμα που μόλις ακούσαμε .	διαπιστώσαμε
Το σύστημα που συζητούμε τη στιγμή αυτή , δηλαδή ο καθορισμός αυστηρότερων προδιαγραφών σχετικά με το χρόνο εργασίας - και μάλιστα δεν πρόκειται εδώ αποκλειστικά για το χρόνο οδήγησης , αλλά γενικά για το χρόνο εργασίας - [MASK] βελτίωση σε σχέση με το παρελθόν .	αποτελεί
Εφόσον , κύριε Επίτροπε , σ τα κράτη μέλη - και γνωρίζω ότι αυτό δεν αποτελεί δική σας αρμοδιότητα - ισχύουν διαφορετικές προδιαγραφές για τον αριθμό χιλιομέτρων ανά ώρα που επιτρέπεται να οδηγεί ένας οδηγός , όλα αυτά δεν θα [MASK] κανένα νόημα .	έχουν
Η απόφαση του Ισραήλ να αποδεσμεύσει τα έσοδα από φόρους για την Παλαιστινιακή Αρχή [MASK] θετικό βήμα " .	αποτελεί
Παρ' όλ' αυτά , το Ανώτατο Δικαστήριο του Ισραήλ [MASK] την απόφαση , καθώς στοιχεία από την ΕΣΣΔ έδειξαν ότι ίσως να μην ήταν ο γνωστός σ τους Εβραίους « Ιβάν ο Τρομερός » .	ανέτρεψε
Ό,τι και να σήμαινε το όνομα Μακεδονία σ την αρχαιότητα , σ τα τέλη του 19ου αιώνα [MASK] τη περιοχή που εκτεινόταν δυτικά από τις λίμνες Οχρίδα και Πρέσπα μέχρι τον ποταμό Νέστο ανατολικά , και από τα βουνά του Σαρ , της Ρίλας και της Ροδόπης από βορρά μέχρι την Πίνδο , τον Όλυμπο και το Αιγαίο προς νότο .	δήλωνε
Εξ αιτίας όμως των μεταξύ τους αντιζηλιών καμία εξ αυτών δεν [MASK] τη δύναμη της απ' ευθείας προσάρτησης του χώρου .	είχε
Το μόνο συνεπώς που μπορούσαν να κάνουν ήταν ν' [MASK] την επιρροή τους σ τους πληθυσμούς της περιοχής , παράλληλα μ' εκείνη προς τον Σουλτάνο σ τη Κωνσταντινούπολη , για όσο χρόνο θα " παρέμενε " ( ή θα του επέτρεπαν ) τη συνέχεια της Αυτοκρατορίας του , προκειμένου να είναι έτοιμες να υποστηρίξουν ένα ή περισσότερους από τους διαδόχους του οθωμανικού καθεστώτος που θα μπορούσαν να ήταν οι Σέρβοι , οι Έλληνες , οι Βούλγαροι , οι Αλβανοί , ακόμα και οι γηγενείς Μακεδόνες , που οι πιθανότητές να ιδρύσουν ανεξάρτητα έθνη δεν ήταν και εντελώς ανύπαρκτες .	αυξήσουν
Οι Έλληνες όμως , εκτός των αποδεδειγμένων ιστορικών αξιώσεων [MASK] και πολυάριθμα χωριά ιδίως σ τα νότια που σχεδόν όλα ήταν ελληνόφωνα , και παρά την εξάπλωση της βουλγαρικής Εξαρχίας με επισκόπους - " βοηθούς " - , τους λεγόμενους protojereji ( = κάτι σαν πρωτοσύγγελοι ) , η Ελληνική Εκκλησία συνέχισε να κυριαρχεί .	κατείχαν
Σ τα πλαίσια της Βαλκανικής Κομμουνιστικής Ομοσπονδίας , τα κομμουνιστικά κόμματα της Βαλκανικής είχαν [MASK] τη σύσταση ενιαίας και ανεξάρτητης Μακεδονίας και Θράκης .	αποδεχθεί
Έτσι όταν ήρθε η ώρα της αποσύνθεσης της ενιαίας Γιουγκοσλαβίας , το κράτος των Σκοπίων [MASK] το αίτημα να αναγνωρισθεί διεθνώς με το όνομα Μακεδονία , προκαλώντας αλλεπάλληλα κύματα αντίδρασης από την πλευρά των Ελλήνων , τόσο σ την Ελλάδα όσο και σ τις χώρες της Ελληνικής Διασποράς .	προέβαλε
Η Αμερικανική Βουλή [MASK] νομοσχέδιο που κατέθεσαν οι Ρεπουμπλικανοί , βάσει του οποίου η Ουάσιγκτον θα μπορεί να δανείζεται για χρονικό διάστημα τεσσάρων μηνών , προκειμένου να καλύψει τις υποχρεώσεις της .	υπερψήφισε
Η ενέργεια αυτή [MASK] την αύξηση του ορίου χρέους των ΗΠΑ και απομακρύνει την απειλή να δηλώσει η Ουάσιγκτον αδυναμία αποπληρωμής των χρεών της , γεγονός που θα έβλαπτε την οικονομία .	καθυστερεί
Σ τη λίμνη [MASK] καταφύγιο πολλά αποδημητικά πουλιά , όπως κύκνοι , τσικνιάδες , πάπιες και άλλα απειλούμενα είδη .	βρίσκουν
Το καλοκαίρι , η παραλία [MASK] πολλούς επισκέπτες , χωρίς αυτό να αφαιρεί τίποτα από τη φυσική ομορφιά του τοπίου .	ελκύει
Ωστόσο , η Αντιπολίτευση ( κυρίως οι Κομμουνιστές ) [MASK] επανάληψη των προεδρικών και των βουλευτικών εκλογών , ενώ ο ΟΑΣΕ κατήγγειλε αρκετές παρατυπίες .	απαιτούν
Η δράση 1 , Νεολαία για την Ευρώπη , [MASK] συναντήσεις ομάδων νέων και την ανταλλαγή νέων .	περιλαμβάνει
Η δράση 2 [MASK] την Ευρωπαϊκή Εθελοντική Υπηρεσία και απευθύνεται σε νέους που μεταβαίνουν σε μια άλλη χώρα ως εθελοντές για χρονικό διάστημα 6_-_12 μηνών .	περιλαμβάνει
Η δράση 3 [MASK] τις πρωτοβουλίες σ τον τομέα της νεολαίας , η δράση 4 την υποστήριξη πρωτοβουλιών που ξεπερνούν το πλαίσιο των μεμονωμένων προγραμμάτων και διεξάγονται από κοινού με τα προγράμματα LEONARDO και ΣΩΚΡΑΤΗΣ .	περιλαμβάνει
Κατά το πρώτο έτος του προγράμματος , [MASK] επανειλημμένα παράπονα για την διάρκεια επεξεργασίας των αιτήσεων .	ακούσαμε
Κατά την πορεία , η Επιτροπή [MASK] την κριτική μας - την ευχαριστούμε γι' αυτό - και επιτάχυνε τη διαδικασία .	υιοθέτησε
Επίσης , η ανταλλαγή εμπειριών μεταξύ των εθνικών υπηρεσιών [MASK] ακόμη βελτιώσεις .	επιδέχεται
Η συμμετοχή των υποψηφίων χωρών σ το πρόγραμμα [MASK] σ την αρχή δυσκολίες , οι νομικές βάσεις εγκρίθηκαν κάπως αργοπορημένα και η χορήγηση θεώρησης πολλές φορές παρουσίασε δυσκολίες .	παρουσίασε
Η διαδικασία διαβούλευσης για τη Λευκή Βίβλο μας [MASK] ενθαρρυντικά μηνύματα και ελπίζω ότι χάρη σ τη νέα αυτή ώθηση προς τη νεολαία της Ευρώπης το πρόγραμμα Νεολαία θα αποτελέσει για εμάς τον πυρήνα αυτής της πολιτικής για τη νεολαία .	δίνει
Ο ΟΗΕ δεν [MASK] τα αίτια θανάτου του Μουάμαρ αλ Καντάφι	εξακρίβωσε
Για " εγκληματική έλλειψη εμβολιαστικής πολιτικής " σ την χώρα [MASK] λόγο ο Ιατρικός Σύλλογος Αθηνών σε ανακοίνωση που εξέδωσε .	κάνει
Μάλιστα , για το θάνατο [MASK] την ευθύνη σ την ανεπαρκή εθνική πολιτική ευαισθητοποίησης του λαού .	επιρρίπτει
Με την προοπτική της κατάπαυσης του πυρός , οι Τούρκοι [MASK] τις πολεμικές τους επιχειρήσεις , καταλαμβάνοντας την Κερύνεια και επεκτείνοντας τη ζώνη κατοχής .	δυνάμωσαν
Λίγο μετά τις 4 το απόγευμα τα διεθνή πρακτορεία [MASK] την καθεστωτική αλλαγή σ την Αθήνα .	μετέδιδαν
Παράλληλα σ την Κύπρο τα γεγονότα [MASK] τον Σαμψών να παραιτηθεί .	υποχρέωσαν
Σ το τέλος των συνομιλιών , σ τις 30_Ιουλίου , [MASK] διακήρυξη , τα κύρια σημεία της οποίας ήταν :	υπέγραψαν
Το Ευρωπαϊκό Κοινοβούλιο [MASK] τον διάλογο μεταξύ Ευρωπαϊκής Ένωσης και Κούβας , ο οποίος διεκόπη από τις κουβανικές αρχές με την ακύρωση της συνάντησης με την τρόικα της Ευρωπαϊκής Ένωσης , που προβλεπόταν για τον Απρίλιο_του_2000 .	γνωρίζει
Επίσης , το Συμβούλιο [MASK] την ευκαιρία να εξετάσει το συγκεκριμένο θέμα σ τη συνεδρίαση της Συνέλευσης Ίσης Εκπροσώπησης ΑΚΕ/ΕΕ που διεξήχθη σ τις Βρυξέλλες από τις 29_Οκτωβρίου έως την 1η_Νοεμβρίου_2001 .	είχε
Κατόπιν λεπτομερούς μελέτης και ανταλλαγών πληροφοριών , το Συμβούλιο [MASK] επίσης σοβαρές ελλείψεις σ την αναγνώριση και την εφαρμογή των ατομικών και πολιτικών ελευθεριών , καθώς και μία άρνηση των κουβανικών αρχών να εξετάσουν την πιθανότητα εισαγωγής μεταρρυθμίσεων με στόχο ένα πολιτικό σύστημα βασιζόμενο σ τις εν λόγω αξίες .	διαπίστωσε
Παρόλα αυτά , το Συμβούλιο [MASK] κάποιες θετικές ενδείξεις : μεγαλύτερη θρησκευτική ελευθερία , τη μη επιβολή εδώ και δύο χρόνια της θανατικής ποινής , πράγμα που μας παραπέμπει σ τον προβληματισμό που αποτελούσε αντικείμενο της προηγούμενης ερώτησης , που είναι μία από τις πολιτικές της Ένωσης .	παρατήρησε
Σ την Αλγερία , ένοπλοι Ισλαμιστές που συνδέονται με την Αλ Κάιντα , [MASK] 41 άτομα που εργάζονταν σε εργοστασιακό συγκρότημα φυσικού αερίου σ την περιοχή ως απάντηση σ τις στρατιωτικές επιχειρήσεις που πραγματοποιεί η Γαλλία σ το Μάλι .	απήγαγαν
Η Γαλλία έχει [MASK] πόλεμο και οι υπόλοιπες δυτικές χώρες θα έχουν πρόβλημα εάν η ανάμειξη συνεχιστεί " .	κηρύξει
Ο Υπουργός Άμυνας των ΗΠΑ , Λίον Πανέτα , [MASK] τις απαγωγές τρομοκρατικές ενέργειες .	χαρακτήρισε
Όπως είπε , " οι ΗΠΑ θα [MASK] όλα τα απαραίτητα μέτρα για να αντιμετωπίσουν την κατάσταση " .	λάβουν
Εάν θέλουμε να φέρουμε εις πέρας το μεταρρυθμιστικό πρόγραμμα που παρουσιάσατε , τότε το Σώμα πρέπει να [MASK] ένα esprit de corps .	αποκτήσει
Ο τρόπος με τον οποίο εντάξατε το Προεδρείο του Κοινοβουλίου , τη Διάσκεψη των Προέδρων και τους προέδρους των επιτροπών σ την ατζέντα σας , ήδη από τον πρώτο μήνα της θητείας σας , [MASK] την αποφασιστικότητά σας να συνεργαστείτε με το σύνολο του Σώματος ώστε να επιτευχθεί η μεταρρύθμιση , και αυτό είναι πολύ ενθαρρυντικό .	δείχνει
Ταυτόχρονα , όμως , [MASK] το ίδιο και με τα υπόλοιπα όργανα .	κάνατε
Εάν έχω να κάνω κάποια κριτική σ την ομιλία σας , αυτή δεν [MASK] το περιεχόμενο - ουσιαστικά συμφωνώ με κάθε σας λέξη - αλλά με το γεγονός ότι διέκρινα , ίσως , ένα στοιχείο εμμονής σ την " αποστολή μας " .	αφορά
Εάν σημειώσετε πρόοδο σ τους τρεις αυτούς τομείς , θα έχετε πράγματι [MASK] πάρα πολλά .	επιτύχει
Σ την ομιλία σας ορθώς [MASK] το δίλημμα που έχουμε να αντιμετωπίσουμε .	επισημάνατε
Γι' αυτό πρέπει να [MASK] τα δύο .	συνδυάσουμε
Ο κ. Dell' Alba [MASK] μία παρατήρηση που ήθελα να κάνω και εγώ .	έκανε
Σ την πραγματικότητα , για τους περισσότερους βουλευτές η ολομέλεια [MASK] πάρεργο όταν επισκέπτονται το Στρασβούργο .	αποτελεί
Θα έπρεπε να [MASK] τον περισσότερο χρόνο τους εδώ .	περνούν
Συνεπώς πρέπει να [MASK] το θέμα και να καταστήσουμε την αίθουσα αυτή επίκεντρο των δραστηριοτήτων μας : μια πιο ζωντανή αίθουσα , όπου θα συζητάμε πραγματικά τα θέματα που θα προκύπτουν .	επανεξετάσουμε
Η πρόταση , κατά την άποψή μας , [MASK] και δεν υπονομεύει την ασφαλή και αξιόπιστη επισκευή των αυτοκινήτων .	βελτιώνει
Για να μπορέσει ένας έμπορος να αναθέσει υπεργολαβικά την υπηρεσία αυτή , αν το επιθυμεί σε επισκευαστή , ο τελευταίος πρέπει να [MASK] από τον κατασκευαστή το καθήκον της παροχής των υπηρεσιών που παρέχουν σήμερα οι έμποροι .	αναλάβει
Σε απάντηση σ τον κ. Berenguer Fuster , η Επιτροπή [MASK] επιλεκτικά συστήματα για πολλά προϊόντα σύμφωνα με τις πολιτικές που εφαρμόζει :	επιτρέπει
το σχέδιο κανονισμού ούτε [MASK] μια ειδική μορφή διανομής ούτε καθορίζει λεπτομερώς πώς πρέπει να διατυπώνονται οι συμφωνίες .	επιβάλλει
Αν μπορώ να κλείσω με μια κάπως γενικότερη παρατήρηση , με αυτή την πρόταση [MASK] δύο πράγματα .	κάνουμε
Το 1944 ο Στάλιν [MASK] όλους τους Τατάρους από την Κριμαία , οι οποίοι επέστρεψαν μετά την κατάρρευση της Σοβιετικής Ένωσης σε μια ανεξάρτητη Ουκρανία .	έδιωξε
Η απουσία αμαξιών σε συνδυασμό με τους πολύχρωμους κήπους , τα δέντρα και τα λουλούδια που περιβάλλουν τα σπίτια , [MASK] τον επισκέπτη .	μαγεύουν
Αυτό το σημείο [MASK] πανοραμική θέα προς τα γύρω νησιά , το Κάστρο και τους κεντρικούς οικισμούς .	προσφέρει
Οι εκκλησίες του χωριού [MASK] μεγάλο ενδιαφέρον .	παρουσιάζουν
Οι δύο μεγαλύτερες ιαπωνικές αεροπορικές εταιρείες [MASK] καθηλωμένα τα νέα αεροσκάφη Boeing 787 Dreamliner μετά την αναγκαστική προσγείωση που πραγματοποίησε ένα από αυτά εξαιτίας ένδειξης που είχε για πρόβλημα σ το ηλεκτρονικό του σύστημα και οι επιβάτες διαμαρτυρήθηκαν για το γεγονός ότι μύριζε σαν να καίγεται κάτι .	κράτησαν
Η πτήση της αεροπορικής εταιρείας " All Nippon " με 129 επιβάτες [MASK] αναγκαστική προσγείωση σ το Τακαμάτσου , ενώ πετούσε με προορισμό το Τόκυο .	πραγματοποίησε
Μετά απ' αυτό το περιστατικό , οι αεροπορικές εταιρείες " Αll Νippon " και " Japan Airways " [MASK] καθηλωμένα σ το έδαφος τα αεροσκάφη 787 που διαθέτουν , προκειμένου να πραγματοποιήσουν ελέγχους ασφάλειας .	κράτησαν
Μετά την αναγκαστική προσγείωση που πραγματοποίησε το αεροσκάφος της " All Nippon " , ο Οσάμου Σινόμπε ( Αντιπρόεδρος ) [MASK] συγγνώμη από τους επιβάτες σε συνέντευξη τύπου που παραχώρησε από το Τόκυο .	ζήτησε
Πάντως και σ τις ΗΠΑ τα απανωτά προβλήματα που έχουν παρουσιαστεί το τελευταίο καιρό με αεροσκάφη 787 της Boeing έχουν [MASK] και τις Αρχές των ΗΠΑ να ξεκινήσουν διερεύνηση ασφαλείας του συγκεκριμένου τύπου αεροπλάνου .	αναγκάσει
Ο Πρόεδρος της Σομαλίας , Χασσάν Σεΐχ Μοχάμουντ , [MASK] συνομιλίες σ την Ουάσιγκτον την Πέμπτη με τον Μπαράκ Ομπάμα , ο οποίος εμφανίστηκε σ τις συνομιλίες του Χασσάντ Μοχάμουντ με τον Αναπληρωτή Σύμβουλο Εθνικής Ασφάλειας των ΗΠΑ .	είχε
Η Χίλαρι Κλίντον [MASK] την εξέλιξη " ορόσημο " .	χαρακτήρισε
Οι πατατοπαραγωγοί θα [MASK] την απευθείας διάθεση του προϊόντος τους σ τους καταναλωτές , μιας και κάτι τέτοιο τους εξασφαλίζει μια σειρά από πλεονεκτήματα .	συνεχίσουν
« Μέχρι σήμερα [MASK] την πατάτα σε χαμηλή τιμή και δεν εισπράτταμε άμεσα τα χρήματά μας .	πουλούσαμε
Υιοθετώντας αυτή την οδηγία , [MASK] ουσιαστική πρόοδο προς την κατεύθυνση της εξάλειψης των στρεβλώσεων του ανταγωνισμού σ τον οδικό τομέα , κυρίως όμως προς την κατεύθυνση της βελτίωσης της οδικής ασφάλειας .	κάνουμε
Η οδηγία αυτή όχι μόνο θα [MASK] την εξάλειψη των καταχρήσεων σ τον τομέα αυτό αλλά θα διευκολύνει επίσης μια καλύτερη ισορροπία μεταξύ των τρόπων μεταφοράς .	επιτρέψει
Η αίτηση προς την Επιτροπή να ερευνήσει τις συνέπειες της εξαίρεσης , και να προτείνει , ως αποτέλεσμα της διερεύνησης αυτής , ειδικούς όρους για τη συμπερίληψη των αυτοαπασχολούμενων οδηγών σ την οδηγία , [MASK] βεβαίως την καλύτερη προσέγγιση .	συνιστά
Το τελικό σχέδιο της οδηγίας , όπως το βλέπουμε τώρα , καταρχάς [MASK] πλήρως τους αρχικούς στόχους της Επιτροπής , δηλαδή τη θέσπιση και ανάπτυξη σε όλη την Ένωση ορθών πρακτικών ενημέρωσης και διαβούλευσης με τους εργαζόμενους που θα εστιάζονται σ την πρόβλεψη και τη διαχείριση των αλλαγών .	ικανοποιεί
Συνεπώς , το ανά χείρας σχέδιο [MASK] την αποδοχή , σαφώς εκ μέρους της Επιτροπής αλλά και εκ μέρους του Κοινοβουλίου και του Συμβουλίου .	αξίζει
Από την στιγμή που θα έχει εγκριθεί , η οδηγία θα [MASK] το κοινοτικό πλαίσιο σ τον τομέα της πληροφόρησης και της διαβούλευσης των εργαζομένων , ένα πλαίσιο το οποίο παρέχει σ τις ευρωπαϊκές επιχειρήσεις και σ τους εργαζομένους σε αυτές ένα ουσιαστικό εργαλείο που θα διευκολύνει την αλλαγή και θα διασφαλίσει τη συνέχειά της με κοινωνικά αποδεκτό τρόπο .	συμπληρώσει
Η Κέρκυρα , πρωτεύουσα του νησιού με χαρακτηριστικό της γνώρισμα τα βενετσιάνικα καντούνια και τα αγγλικά αρχοντικά [MASK] διεθνές τουριστικό κέντρο .	αποτελεί
Σύμφωνα με τη μυθολογία ο Ποσειδώνας [MASK] σ το νησί τη νύμφη Κέρκυρα , η οποία και έδωσε το όνομα της σ το νησί .	έφερε
Κατά τα κλασσικά χρόνια [MASK] την πρώτη σημαντική σύγκρουση του Πελοποννησιακού πολέμου για να περιέλθει σ τη συνέχεια σ τη ρωμαϊκή κατοχή .	αποτέλεσε
Η εκκλησία του Αγίου Σπυρίδωνα πολιούχου της Κέρκυρας , όπου φυλάσσεται το ιερό σκήνωμα του Αγίου , χτισμένη το 1589 [MASK] σημαντικό μνημείο του νησιού .	αποτελεί
Η Εισαγγελία της Γερμανίας [MASK] την κατοικία του Κρίστιαν Βουλφ	ερευνά
Η Εισαγγελία της Γερμανίας [MASK] την έρευνά της σ την κατοικία του πρώην Προέδρου της Γερμανίας , Κρίστιαν Βουλφ .	ξεκίνησε
Νωρίτερα , ο Κρίστιαν Βουλφ [MASK] την συγκατάθεση του για την έρευνα και δεν χρειάστηκε ειδικό ένταλμα .	έδωσε
Ο πρώην συμβασιούχος της αμερικανικής Υπηρεσίας Εθνικής Ασφάλειας , Έντουαρντ Σνόουντεν , [MASK] προσωρινό άσυλο σ τη Ρωσία , έως ότου μπορέσει να ταξιδέψει σ τη Λατινική Αμερική και το Κρεμλίνο έχει αφήσει να εννοηθεί ότι ενδεχομένως να του επιτρέψει να παραμείνει σ τη χώρα , αν σταματήσει να διαρρέει πληροφορίες για τα απόρρητα προγράμματα των ΗΠΑ .	επιδιώκει
Αργότερα η οργάνωση Wikileaks [MASK] σ τη δημοσιότητα ανακοίνωση του Σνόουντεν που αναφέρει ότι θα ήθελε να παραμείνει σ τη Ρωσία , έως ότου μπορέσει να μεταβεί με ασφάλεια σ τη Λατινική Αμερική .	έδωσε
Πάντως ο Ρώσος Πρόεδρος Βλαντιμίρ Πούτιν έχει [MASK] το αμερικανικό αίτημα , συνιστώντας όμως παράλληλα σ το Σνόουντεν να αναχωρήσει για άλλη χώρα .	απορρίψει
Ο Έντουαρντ Σνόουντεν , που παραμένει επί τρεις εβδομάδες σ την αίθουσα μετεπιβιβάσεων του αεροδρομίου Σερεμέτιεβο της Μόσχας , είχε [MASK] άσυλο απ’ τη Ρωσία , αλλά απέσυρε τότε το αίτημα όταν ο κ. Πούτιν είχε δηλώσει ότι για να του δοθεί άσυλο θα πρέπει να σταματήσει να διαρρέει άλλες λεπτομέρειες για τα απόρρητα προγράμματα των ΗΠΑ .	ξαναζητήσει
Το 1794 οι αγιορείτες μοναχοί Νύμφωνας Χίος και Γρηγόριος Χατζησταμάτης [MASK] την Ιερά Μονή της Ευαγγελίστριας , η οποία τότε ονομαζόταν " Νέο Μοναστήρι " για να ξεχωρίζει από τα παλαιότερα .	ίδρυσαν
Το ανδρικό μοναστήρι , που ολοκληρώθηκε το 1806 , [MASK] σημαντικό ρόλο κατά τη διάρκεια της ιστορίας του καθώς συνέβαλε σ τον απελευθερωτικό αγώνα κατά των Τούρκων και αποτέλεσε καταφύγιο άπορων οικογενειών .	διαδραμάτισε
Τα μέλη της αντιπροσωπείας [MASK] την ευκαιρία να συνομιλήσουν με φοιτητές που θα μπορούσαν να χρησιμοποιήσουν τη μηχανή αναζήτησης της " Google " για την πρόσβασή τους σ το διαδίκτυο .	είχαν
Πάντως , το Υπουργείο Εξωτερικών των ΗΠΑ έχει [MASK] το εν λόγω ταξίδι , χαρακτηρίζοντας " άστοχη " τη χρονική περίοδο που πραγματοποιείται .	επικρίνει
Κύριε Πρόεδρε , αγαπητοί συνάδελφοι , [MASK] ήδη την ευκαιρία σ τις 15_Ιανουαρίου να σας συγχαρούμε για την ανάληψη του αξιώματός σας .	είχαμε
Όπως είναι γνωστό , σήμερα το απόγευμα θα [MASK] σχετικές διαβουλεύσεις με τον Πρόεδρο .	έχουμε
Για τον λόγο αυτόν , η συνέλευση πρέπει να [MASK] σ το σύνολό της το επίκεντρο των εργασιών .	αποτελέσει
η Ομάδα μας είναι υπέρ του να [MASK] καθεστώς βουλευτών .	αποκτήσουμε
η Ομάδα μας είναι υπέρ του να [MASK] καθεστώς βουλευτών .	αποκτήσουμε
Σε τελευταία ανάλυση λοιπόν το ζητούμενο δεν είναι να [MASK] " ναι " σε κάτι που προτείνει το Συμβούλιο , αντίθετα , εμείς είμαστε που υποβάλλουμε τις προτάσεις και μετά από αυτό πρέπει να καταλήξουμε σε κάτι από κοινού με το Συμβούλιο .	πούμε
Αν αντιμετωπίσουμε μελλοντικά με τον τρόπο αυτόν την αποστολή μας , θα [MASK] επιτυχίες .	σημειώσουμε
Τελευταίο , αλλά όχι λιγότερο σημαντικό , το γενικό καθεστώς δεν [MASK] διατάξεις που είναι ζωτικής σημασίας σ τον τομέα του αυτοκινήτου για να διασφαλίσει τα οφέλη για τον καταναλωτή .	προσφέρει
Ωστόσο , κάτι τέτοιο [MASK] ξεκάθαρες ενδείξεις από πλευράς Βόρειας Κορέας , που μέχρι τώρα δεν έχουν εμφανιστεί .	απαιτεί
Μάλιστα , όπως ανακοινώνουν οι υπεύθυνοι [MASK] τις έρευνες , οι οποίες ξεκίνησαν τον Απρίλη του 2004 , ώστε να έχει παρασκευαστεί ένα εμβόλιο μέχρι το τέλος του χρόνου .	επιτάχυναν
Οι νέοι Κινέζοι άποικοι έχουν [MASK] μία εναλλασσόμενη κοινωνία : ένα κινεζικό απαρτχάιντ το οποίο , μέσω της άρνησης ίσων κοινωνικών και οικονομικών δικαιωμάτων σ την ίδια μας τη γη , προσπαθεί να μας καταβάλει και να μας απορροφήσει .	δημιουργήσει
Σε μία συλλογή ομιλιών του , που εκδόθηκε σ την Ινδία το 1998 , ο Δαλάι Λάμα [MASK] ξανά λόγο για " κινεζικό απαρτχάιντ " , μέσω της άρνησης ίσων κοινωνικών και οικονομικών δικαιωμάτων για τους Θιβετιανούς .	έκανε
Μετά την εισβολή τους σ το Θιβέτ το 1950 , οι Κινέζοι κομμουνιστές [MASK] πάνω από ένα εκατομμύριο Θιβετιανούς , κατέστρεψαν περισσότερα από 6.000 μοναστήρια , και μετέτρεψαν τη βορειοανατολική επαρχία , την Amdo , σε ένα γκούλαγκ που στεγάζει σύμφωνα με εκτιμήσεις έως και δέκα εκατομμύρια ανθρώπους .	σκότωσαν
Εξαιτίας του , όπως έχει οριστεί , κινεζικού απαρτχάιντ , οι Θιβετιανοί [MASK] σήμερα χαμηλότερο προσδόκιμο ζωής , ποσοστό αλφαβητισμού , και κατά κεφαλή εισόδημα από τους Κινέζους αποίκους του Θιβέτ .	έχουν
Η Θιβετιανή Κοινότητα του Ηνωμένου Βασιλείου [MASK] τη βρετανική κυβέρνηση να " καταδικάσει το καθεστώς απαρτχάιντ σ το Θιβέτ που αντιμετωπίζει τους Θιβετιανούς ως μειονότητα σ τη δική τους γη , και που τους φέρνει αντιμέτωπους με διακρίσεις σ τη χρήση της γλώσσας τους , σ την εκπαίδευση , σ την άσκηση της θρησκείας τους , και σ την αγορά εργασίας " .	κάλεσε
Τα ευρωπαϊκά πολεμικά [MASK] με τα πυροβόλα τους , τους επαναστάτες σ το Ακρωτήρι , ρίχνοντας τη σημαία που υψώθηκε αμέσως πάλι υπό τις θυελλώδεις ζητωκραυγές των πληρωμάτων των ελληνικών πολεμικών που ναυλοχούσαν στ' ανοιχτά αλλά δεν μπορούσαν να επέμβουν ενώ σ το θωρηκτό " Ύδρα " γινόταν ανάκρουση του Εθνικού μας Ύμνου .	χτύπησαν
Το ίδιο βράδυ του βομβαρδισμού , ο Βενιζέλος [MASK] διαμαρτυρία προς τους ξένους ναυάρχους , την οποία προσυπέγραψαν όλοι οι οπλαρχηγοί που βρίσκονταν σ το Ακρωτήρι .	συνέταξε
Ο βομβαρδισμός αυτός χριστιανικών πλοίων εναντίον Χριστιανών που ήθελαν την ελευθερία τους , [MASK] μεγάλη συγκίνηση και σ την Ελλάδα και σ την Ευρώπη .	προκάλεσε
Σ τις 25_Αυγούστου_1897 , ο Βενιζέλος [MASK] διακοίνωση σ τον αρχηγό του ευρωπαϊκού στόλου , αναφέροντας ότι η μόνη σωστή λύση του Κρητικού ζητήματος θα ήταν η ένωση του νησιού με την Ελλάδα .	έστειλε
Αφού όμως η Ελλάδα απέσυρε τη στρατιωτική δύναμη που είχε σ το νησί , αναγνωρίζοντας την αυτονομία του , θα έπρεπε και η Κρήτη , για να μην φέρει σε δύσκολη θέση την Αθήνα , να [MASK] ως προσωρινή λύση την αυτονομία , εναποθέτοντας τις ελπίδες για οριστική λύση σ τις Μεγάλες Δυνάμεις .	δεχθεί
Κατόπιν οι Μεγάλες Δυνάμεις [MASK] τη διαδικασία διακανονισμού του Κρητικού ζητήματος , που όμως τραβούσε μακριά .	ξεκίνησαν
Σ τις 21_Ιανουαρίου_1898 , η κρητική συνέλευση , μέσα σε ζητωκραυγές [MASK] πρόταση του Βενιζέλου να κάνει το προεδρείο της τα αναγκαία διαβήματα .	ενέκρινε
Ο Μιτ Ρόμνεϊ [MASK] ακόμα μια νίκη σ τις προκριματικές εκλογές για το προεδρικό χρίσμα των Ρεπουμπλικανών , αφού επικράτησε έναντι του Ρικ Σαντόρουμ σ το Ιλινόις .	πέτυχε
Ο Μιτ Ρόμνεϊ [MASK] το 45% των ψήφων , δέκα ποσοστιαίες μονάδες περισσότερες από τον Ρικ Σαντόρουμ .	έλαβε
Ο Νιουτ Γκίνγκριτς [MASK] 12% των ψήφων ενώ το υπόλοιπο 8% έλαβε ο Ρον Πωλ .	έλαβε
Ο Μιτ Ρόμνεϊ [MASK] την πολιτική του Μπαράκ Ομπάμα , ενώ ο Ρικ Σαντόρουμ υποσχέθηκε να συνεχίσει τον αγώνα .	επίκρινε
Τουλάχιστον 30 άτομα [MASK] τη ζωή τους .	έχασαν
Το χαλάζι έχει [MASK] το μέγεθος μπάλας του μπέιζμπωλ .	φτάσει
Ο πρόεδρος Ομπάμα [MASK] τα συλλυπητήριά του προς τα θύματα , ενώ δεσμεύτηκε ότι η κυβέρνηση θα βοηθήσει τους πληγέντες να ανακτήσουν τις δυνάμεις τους και να αποκαταστήσουν τις ζημιές .	εξέφρασε
Κύριε Solana , [MASK] την πλήρη υποστήριξή μου σ την επισήμανσή σας ότι η ΕΕ πρέπει να συνεχίσει τις προσπάθειές της .	έχετε
Ωστόσο , το Ισραήλ δεν [MASK] τη μεσολάβησή μας .	θέλει
Εδώ και ενάμισι χρόνο [MASK] άπραγοι τον εντελώς άνισο πόλεμο που διεξάγουν αυτοί οι δύο αντίπαλοι μεταξύ τους , κοιτάζουμε τα τανκς των Ισραηλινών να καταστρέφουν σπίτια και να σκοτώνουν παλαιστίνιους πολίτες .	κοιτάζουμε
Από την άλλη πλευρά [MASK] και τους παλαιστίνιους αυτόχειρες να παίρνουν μαζί τους σ τον θάνατο εντελώς αθώους ισραηλινούς πολίτες .	βλέπουμε
Ο Σπυρίδων Λάμπρος [MASK] κυβέρνηση με μη πολιτικά πρόσωπα .	σχημάτισε
Σ τις 11/24_Νοεμβρίου_1916 η ολοκληρωμένη Προσωρινή Κυβέρνηση [MASK] τον πόλεμο σ τις κεντρικές δυνάμεις .	κήρυξε
Ως αποτέλεσμα αυτών των συνθηκών η Ελλάδα [MASK] ( προσωρινά ) την Ανατολική Θράκη και την Σμύρνη .	προσάρτησε
Εν τω μεταξύ είχε ήδη [MASK] την οδυνηρή περιπέτεια της Μικρασιατικής καταστροφής που εξυπηρετούσε τα σχέδια των Μεγάλων Δυνάμεων σ την περιοχή και βασίστηκε σε αβάσιμους σχεδιασμούς όπως αυτοί συνοψίζονταν σ το δόγμα " Η Ελλάς των δύο ηπείρων και των πέντε θαλασσών " .	χρεωθεί
Εκτός όμως από τα μνημεία του παρελθόντος τα Σύβοτα [MASK] πόλο έλξης μεγάλου αριθμού τουριστών .	αποτελούν
Ο Πρόεδρος της Ευρωπαϊκής Επιτροπής , Μανουέλ Μπαρόζο , και ο Επικεφαλής των Φιλελεύθερων του Ευρωκοινοβουλίου και πρώην Πρωθυπουργός του Βελγίου , Γκι Φέρχοφστατ , [MASK] τα συλληπήτηρια τους σ τις οικογένειες των θυμάτων .	εξέφρασαν
Ο Πρόεδρος της Γαλλίας , Νικολά Σαρκοζί , θα [MASK] την έκδοσή του » .	ζητήσει
Ωστόσο , ο ηγέτης του Μετώπου της Αριστεράς [MASK] απεργία πείνας ως ένδειξη διαμαρτυρίας .	κήρυξε
Χθες , η Μπενφίκα [MASK] την Ζενίτ Αγίας Πετρούπολης με σκορ 2:0 , κατά τη διάρκεια του επαναληπτικού αγώνα σ τη φάση των 16 του Τσάμπιονς Λιγκ 2011-2012 .	νίκησε
Αυτή η νίκη [MASK] σ τη Μπενφίκα την πρόκριση σ την επόμενη φάση του Τσάμπιονς Λιγκ .	έδωσε
Παράλληλα , η Άρσεναλ [MASK] την Μίλαν με σκορ 3:0 , αλλά προκρίθηκε η δεύτερη .	νίκησε
O Πρόεδρος των ΗΠΑ , Μπαράκ Ομπάμα , [MASK] την δέσμευσή του ότι θα εξεταστούν όλες οι εναλλακτικές λύσεις , συμπεριλαμβανομένης και της στρατιωτικής αναμέτρησης , για να μην αποκτήσει το Ιράν πυρηνικά όπλα .	επανέλαβε
Από τη πλευρά του ο Πρωθυπουργός του Ισραήλ , Βενιαμίν Νετανιάχου , [MASK] ικανοποίηση για το σχόλιο του Μπαράκ Ομπάμα ότι « θα εξεταστούν όλες οι εναλλακτικές λύσεις αναφορικά με το πυρηνικό πρόγραμμα του Ιράν » .	εξέφρασε
Επίσης ο Βενιαμίν Νετανιάχου [MASK] ικανοποίηση για την θέση του Αμερικανού Προέδρου ότι « το Ισραήλ θα πρέπει να μπορεί να αμυνθεί ενάντια σε οποιαδήποτε απειλή » .	εξέφρασε
Οι Αρχές της Μισουράτας ( ή Μισράτας ) , της τρίτης μεγαλύτερης πόλης σ τη Λιβύη , [MASK] την επιθυμία τους για καθεστώς ημιαυτονομίας .	εξέφρασαν
« Η πόλη μας [MASK] καθεστώς ημιαυτονομίας .	κήρυξε
Οι αρχές των πόλεων [MASK] αυτή την επιθυμία σε συνέδριο που διεξήχθη σ τη Βεγγάζη .	εξέφρασαν
Ο Χάουμε Μάτας είχε [MASK] παρανόμως 500.000 ευρώ ( δημόσια χρήματα ) , για να πληρώσει δημοσιογράφο που έγραφε τις ομιλίες του .	λάβει
Κύριε Πρόεδρε , οι υπό συζήτηση υποθέσεις [MASK] πολύ σοβαρές κατηγορίες , οι οποίες βαρύνουν δύο βουλευτές του Σώματος και αναφέρονται σ την πρώτη σελίδα της αιτιολογικής έκθεσης της έκθεσής μου , σ την οποία συνιστώ σ τους συναδέλφους να ρίξουν μια ματιά .	αφορούν
Με αυτές τις κατηγορίες , από τις οποίες η πρώτη αφορά λαθρεμπόριο όπλων κλπ. , και βαρύνει τόσο τον κ. Pasqua όσο και τον κ. Marchiani , ενώ η δεύτερη στρέφεται μόνον εναντίον του κ. Pasqua , οι ανακριτές δικαστές [MASK] την άρση της βουλευτικής ασυλίας των εν λόγω δύο κυρίων , προκειμένου να τους επιβληθούν ορισμένα μέτρα δικαστικής επιτήρησης : να τους απαγορευθεί η επαφή με διάφορους μάρτυρες ή συγκατηγορουμένους σ τις υποθέσεις αυτές και η μετάβαση σε διάφορες χώρες , καθώς και να τους επιβληθεί ενδεχομένως η καταβολή εγγύησης .	ζητούν
Όμως , ο Υπουργός Δικαιοσύνης [MASK] την αίτηση άρσης της ασυλίας , συνοδευόμενη από τις διαβιβαστικές επιστολές τόσο του Εισαγγελέα Πλημμελειοδικών όσο και του Εισαγγελέα Εφετών , χωρίς να προβαίνει σε κανέναν σχολιασμό .	διαβίβασε
Ο Εισαγγελέας σ τη Γαλλία [MASK] το δικαίωμα να εκπληρώνει τα καθήκοντά του βάσει του νόμου και το Σώμα δεν λαμβάνει θέση σχετικά με αυτό .	έχει
Συνεπώς , η παρούσα αίτηση άρσης της ασυλίας δεν [MASK] το ζήτημα εάν οι διώξεις μπορούν ή πρέπει να συνεχιστούν με βάση το γαλλικό δίκαιο .	αφορά
Τόσο το ζήτημα της ασυλίας όσο και η αίτηση για άρση της [MASK] σχέση μόνο με το εάν το Δικαστήριο μπορεί να εκδώσει δεσμευτικά βουλεύματα για τον περιορισμό της ελεύθερης μετακίνησης των βουλευτών του Ευρωπαϊκού Κοινοβουλίου ή την ελευθερία τους να έρχονται σε επικοινωνία με άλλα πρόσωπα .	έχουν
Υπ' αυτές τις συνθήκες , η Επιτροπή Νομικών Θεμάτων , της οποίας τη θέση αποδέχομαι πλήρως , [MASK] την απόρριψη της αίτησης άρσης της βουλευτικής ασυλίας την οποία υπέβαλε το γαλλικό Υπουργείο Δικαιοσύνης , σ τη μορφή υπό την οποία υποβλήθηκε σ το Κοινοβούλιο .	προτείνει
« Εγώ δεν [MASK] κινητό » απαντάει ο Σαμίρ , που δουλεύει σ τη λαχαναγορά .	έχω
« Ο “ Ποσειδών 16 ” μας [MASK] κι άλλο μήνυμα » μου δηλώνει με χαμόγελο και ακουμπάει μπροστά μου την εκτύπωση του μηνύματος .	στέλνει
Πέραν αυτού , δε [MASK] κάποιο ιδιαίτερο ενδιαφέρον σ την πληροφορία , αλλά για να μ' επισκέπτεται ο Σωτηρόπουλος , που είναι πολύ έμπειρος , κάτι θα πρέπει να του έχει κινήσει την περιέργεια .	βρίσκω
« Τόσα χρόνια [MASK] τη μοίρα σου » .	έκλαιγες
« Ακόμα και αν το κάναμε , πόσο αξιόπιστη θα [MASK] το δικαστήριο την αστυνομία του Ιράκ ; »	θεωρούσε
Ο δολοφόνος του δεν [MASK] την πρόθεση , ή και το χρόνο , να μπει σ το σπίτι και να το ψάξει .	είχε
Το διαμέρισμά τους [MASK] δύο δωμάτια με ενδιάμεσο χολ και σ το βάθος την κουζίνα και το μπάνιο .	έχει
« Όχι , σας [MASK] ακριβώς τη συζήτηση » .	μετέφερα
Ωραία η ανάπτυξη , αλλά και σ την ανάπτυξη δε [MASK] εταιρείες από τον ουρανό .	βρέχει
Κανείς δεν της [MASK] σημασία , γιατί όλοι περιμένουμε σειρά , με το πιάτο σ το χέρι .	δίνει
Ναι , αν [MASK] κανείς έτσι αυτό που μου είπε .	δει
Γι ' αυτό να [MASK] τα νώτα σου , γιατί φοβάμαι πως ούτε εγώ θα μπορώ να σε βοηθήσω .	φυλάς
« Ναι , [MASK] την υπέρβαση να εμφανιστώ μετά από πολύ καιρό σε συνέντευξη τύπου , μπας και λύσω τις απορίες μου , αλλά , όπως είδες , ούτε εγώ πήρα απάντηση » .	έκανα
Έστω και αν ο υπαρχηγός δεν συγκάλυψε « κακήν τινα πράξιν » , [MASK] ωστόσο τη σχέση της δολοφονίας με τα ναρκωτικά και δε θέλησε να ψάξει αν η δολοφονία του Λαλόπουλου προήλθε από πανικό , όπως υποστήριξαν οι ληστές , ή μπορεί και από ψυχρή εκτέλεση , όπως ισχυρίζομαι εγώ .	απέκρυψε
Μετά τους εναγκαλισμούς και τις διαχύσεις , [MASK] κι εμείς τη θέση μας σ το τραπέζι .	παίρνουμε
Αν αποφασίσει ότι πρέπει να συνεχίσουμε την έρευνα , θα [MASK] γραπτή εντολή .	ζητήσουμε
« Το ταξί [MASK] taxiplon » .	έχει
Ο Δημητρίου της σήμανσης [MASK] την τσάντα του και βγάζει χειρουργικές μάσκες .	ανοίγει
Το Σέατ δε [MASK] σειρήνα και αναρωτιέμαι αν θα φτάσω σ την ώρα μου σ το ραντεβού ή αν θα βαρεθεί ο Κυριαζίδης και θα με φτύσει .	διαθέτει
« Η αύξηση θα σου [MASK] πιθανώς τη δόση του δανείου » .	καλύψει
Η οικονόμος έχει [MASK] επίσης την πόρτα και πετάγεται από την κουζίνα .	ακούσει
Οι γραφειοκράτες δεν [MASK] ούτε σπιθαμή από τους νόμους και τους κανονισμούς .	ξεφεύγουν
Σ τα επόμενα δυο κουδούνια δεν [MASK] καμία απάντηση , ώσπου χτυπάμε το κουδούνι σ το διαμέρισμα του πρώτου ορόφου , κάτω από το διαμέρισμα του Πετράκη .	παίρνουμε
Πριν φύγω , του [MASK] το χέρι μου .	απλώνω
Το βραχιόλι το [MASK] εγώ .	αγόρασα
« Θ ' [MASK] κανένα γερό αυγό μπας και τσουγκρίσουμε κι αύριο ; »	αφήσεις
Όταν επιστρέφω σ το γραφείο μου , [MASK] τον Παπαδάκη , που μου λέει ότι έχουν τον Ασιάτη σ το δωμάτιο ανακρίσεων .	βρίσκω
Όταν το βγάζει , [MASK] μια δέσμη από πενηντάρικα ευρώπουλα , τυλιγμένα με λαστιχάκι .	κρατάει
Η προσπάθειά του [MASK] κάπου μία ώρα , αλλά τα καταφέρνει .	παίρνει
« Πολλοί ετοιμοθάνατοι [MASK] μια σύντομη περίοδο αναλαμπής , πριν τελειώσουν » .	περνούν
Σ το πλευρό του [MASK] τον Κλεάνθη Χαρδάκο , και άλλους δύο , μεγαλύτερης ηλικίας , που δεν τους γνωρίζω .	έχει
« Εκτός αυτού , σας [MASK] όλα όσα προέκυψαν από την έρευνα μέχρι τούδε » .	είπα
Το άλλο του [MASK] την καρωτίδα .	έκοψε
« Όταν έφυγε [MASK] τα δικά της , αλλά ήταν τόσο βίαιος ο χωρισμός , που ξέχασε να του ζητήσει το άλλο ζευγάρι » .	πήρε
Πριν αρχίσω να ντύνομαι , [MASK] τηλέφωνο τον Βλασόπουλο και του λέω να με συναντήσει , μαζί με τον Παπαδάκη , σ το αστυνομικό τμήμα του Αγίου Παντελεήμονα .	παίρνω
« Σε λίγο θα [MASK] μάσκα και βατραχοπέδιλα » είναι το σχόλιό του .	χρειάζεστε
Ο Λαλόπουλος δεν [MASK] άλλο ακίνητο , εκτός από το σπίτι του σ το Χαλάνδρι .	είχε
Με άλλα λόγια , [MASK] αιτήματα και τα διαβίβαζε αρμοδίως .	έπαιρνε
Αντί να σκεφτώ πόσο πιο άνετα μπορούμε να ζήσουμε με την Αδριανή χάρη σ τις νυν και σ τις μελλοντικές αυξήσεις , [MASK] τα σωθικά μου με τη δολοφονία του Χαρδάκου .	τρώω
Δίπλα σ' αυτά , η Αδριανή [MASK] και τέσσερα κομμάτια κολοκυθόπιτα , που τα κρατάει πάντα σ την κατάψυξη για ώρα ανάγκης .	εμφάνισε
Τα στελέχη του , όλα ανεξαιρέτως , [MASK] την ίδια ερώτηση : « και αν ; » , δίχως να μπαίνουν σε λεπτομέρειες .	διατύπωναν
« Κώστα μου , έχουμε [MASK] τις άπειρες δυσκολίες » .	περάσει
Σ το μεταξύ [MASK] εκτενή ενημέρωση σ τους βοηθούς μου .	κάνω
Εξ ου και μου [MASK] ένα πλάγιο βλέμμα , όταν με βλέπει να παίρνω θέση δίπλα της .	ρίχνει
Αυτή τη φορά [MASK] εμάς η μπάλα .	πήρε
Μήπως ο άντρας σου [MASK] έναν υπολογιστή ;	έφερε
Όσον αφορά τον ορισμό της τρομοκρατίας : η Ομάδα μου [MASK] σημαντικές διάφορες εγγυήσεις που περιλαμβάνονται σ τις αιτιολογικές σκέψεις και σ τη δήλωση του Συμβουλίου της 6ης_Δεκεμβρίου , όπως για παράδειγμα , και παραθέτω πάλι , ότι τίποτα σε αυτή την απόφαση πλαίσιο " δεν θα πρέπει να ερμηνευθεί ως ότι επιτρέπεται να καταγγέλλονται για τρομοκρατικές ενέργειες άτομα τα οποία ασκούν το θεμελιώδες δικαίωμα της ελεύθερης έκφρασης γνώμης , ακόμη και εάν πραγματοποιούν παραβάσεις κατά την άσκηση του δικαιώματος αυτού " .	θεωρεί
Η πόλη , από την απελευθέρωση της από τον τουρκικό ζυγό το 1913 μέχρι την ανακήρυξή της σε πρωτεύουσα του νομού , το 1936 , [MASK] ένα μικρό παραθαλάσσιο χωριό με πεντακόσιους περίπου κατοίκους .	αποτελούσε
Το 49 μ.Χ. ο Απόστολος Παύλος [MASK] εδώ την πρώτη εκκλησία του Χριστού σ την Ευρώπη γι' αυτό και αργότερα , τον 5ο αιώνα , η πόλη ονομάστηκε Χριστούπολη .	ίδρυσε
Ένας περίπατος σ τους δρόμους και τα σοκάκια της Παλιάς και Νέας Πόλης [MASK] την ευκαιρία σ τον επισκέπτη να θαυμάσει μερικές εικόνες από το παρελθόν της πόλης .	δίνει
« Η δοκιμή της Β. Κορέας [MASK] τη σημασία της συνέχισης ανάπτυξης αντιπυραυλικής άμυνας για την προστασία τόσο της χώρας μας , όσο και των συμμάχων μας σ την Ασία » .	δείχνει
Τέσσερις ώρες αργότερα , η Πιονγιάνγκ [MASK] την αποστολή επιτυχημένη .	κήρυξε
Με την κίνησή της αυτή η Βόρειος Κορέα [MASK] τις πιέσεις ηγετών που ζητούσαν από την Πιονγιάνγκ να ματαιώσει την εκτόξευση , λέγοντας ότι αποτελεί απειλή για την ειρήνη σ τη ΝΑ Ασία .	αψηφά
Μετά από πέντε λεπτά , ο Ντέβιντς [MASK] το τελικό 1:2 για τη Μεταλίστ .	διαμόρφωσε
Η Υπουργός Εξωτερικών των ΗΠΑ , Χίλαρι Κλίντον , [MASK] τελικά εξιτήριο από νοσοκομείο της Νέας Υόρκης , σ το οποίο νοσηλευόταν τις τελευταίες ημέρες για θρόμβο που είχαν εντοπίσει οι γιατροί σ το κεφάλι της .	πήρε
Η Ρωσική Αστυνομία [MASK] δεκάδες διαδηλωτές που πραγματοποιούσαν συγκέντρωση διαμαρτυρίας έξω από τηλεοπτικό σταθμό σ τη Μόσχα , ο οποίος μετέδωσε ντοκιμαντέρ που έδειχνε ανθρώπους να πληρώνονται για να συμμετάσχουν σ τις διαδηλώσεις κατά του Βλαντιμίρ Πούτιν .	συνέλαβε
Πολλοί από τους διαδηλωτές [MASK] συνθήματα όπως « ντροπή σου ΝΤV » και « Ρωσία χωρίς τον Πούτιν » .	φώναζαν
Ο ακτιβιστής της ρωσικής αντιπολίτευσης Σεργκέι Ουνταλτσόφ , που ήταν μεταξύ των συλληφθέντων [MASK] τους δημοσιογράφους που γύρισαν το ντοκιμαντέρ « προδότες » .	χαρακτήρισε
Οι έντεκα γλώσσες [MASK] 110 συνδυασμούς .	δημιουργούν
Πράγματι , ο επόμενος Πρόεδρός μας δεν θα [MASK] πολύ χρόνο για ταξίδια .	έχει
Κάθε ψήφος υπέρ μου [MASK] το εξής σαφές μήνυμα προς τους κκ Cox και Martin :	αποτελεί
Εάν ξέραμε , τότε δεν θα [MASK] χρόνο να υπηρετήσουμε το λαό μας .	είχαμε
Σήμερα , πολλοί βουλευτές δεν [MASK] τη δυνατότητα να λαμβάνουν το λόγο κατά τις συζητήσεις .	έχουν
Ακόμη και σ τις επιτροπές συνδιαλλαγής , οι βουλευτές μας δεν [MASK] πρόσβαση σε έγγραφα εργασίας , νομικά σημειώματα ή συνοπτικά πρακτικά .	έχουν
Η Επιτροπή και το Συμβούλιο [MASK] όλες τις πληροφορίες που δεν μπορούμε να αποκτήσουμε .	διαθέτουν
Σε όλο αυτό το διάστημα που είμαι εκλεγμένος βουλευτής δεν έχω [MASK] ποτέ επαρκή πληροφόρηση από την επιτροπή .	λάβει
Για να λάβω πληροφορίες , πρέπει να [MASK] πηγές , όπως δημοσιογράφους .	ανακαλύπτω
Ο επόμενος Πρόεδρός μας θα πρέπει να [MASK] τη δημοκρατία .	επανεδραιώσει
Θα πρέπει να μας [MASK] το έναυσμα για να συζητήσουμε εάν η μελλοντική Ευρώπη θα αποτελέσει την υλοποίηση του ομοσπονδιακού οράματος μιας δημοκρατικής ΕΕ ή μιας Ευρώπης δημοκρατιών .	δώσει
Ο επόμενος Πρόεδρός μας θα πρέπει να [MASK] όλους τους αιρετούς εκπροσώπους των εθνικών κοινοβουλίων και του Ευρωπαϊκού Κοινοβουλίου , για τη μετατροπή της νομοθετικής διαδικασίας από διαδικασία κεκλεισμένων των θυρών σε ανοικτή διαδικασία , από διαδικασία δημοσίων υπαλλήλων σε διαδικασία εκλεγμένων βουλευτών .	ενώσει
Για όσα πρέπει να γίνουν , εγώ [MASK] τις ικανότητες και την ενεργητικότητά μου .	προσφέρω
Όμως το μόνο που ζητώ είναι να [MASK] την ψήφο σας για τον πρώτο γύρο : πρώτον , επειδή μπορεί να είναι η μόνη σας ευκαιρία να με ψηφίσετε και δεύτερον , επειδή οι πολλές ψήφοι θα θέσουν σε δοκιμασία τις Ομάδες που βρίσκονται πίσω από τους κκ. Cox και Martin .	δανειστώ
Αυτή τη φορά [MASK] έναν πρακτικό και πολιτικά ουδέτερο εκπρόσωπο για να υπηρετήσει όλους μας .	χρειαζόμαστε
Σ το τέλος της ημέρας , θα [MASK] μια καλύτερη προεδρία , χάρις σε εκείνους που σχεδίασαν την " πλατφόρμα της δίκαιης προεδρίας " και δημιούργησαν την πρώτη πραγματική εκλογική μάχη σ την ιστορία μας .	έχουμε
Ο επόμενος πρόεδρος θα [MASK] πραγματική εντολή και αξίζει την πλήρη υποστήριξή μας .	διαθέτει
Η ομάδα με επικεφαλής τον οικονομολόγο Τίμοθι Χάτον [MASK] το ύψος των ανδρών σε ηλίκια περίπου 21 την περίοδο 1870 - 1980 από 15 ευρωπαϊκές χώρες .	ανέλυσε
Προκειμένου να δημιουργηθεί το πρόγραμμα η επιστημονική ομάδα από το Στάνφορντ [MASK] στοιχεία από ζώα και ανθρώπους πριν και μετά την εγχείρηση , ώστε πάνω σ το μοντέλο , που δημιούργησε μπορεί να υπολογίσει την έκβαση της εγχείρησης .	χρησιμοποίησε
Μάλιστα , οι επιστήμονες [MASK] τις μελέτες για να πάρουν περισσότερα στοιχεία , ώστε να προβλέπουν το αποτέλεσμα των εγχειρήσεων σ τα αιμοφόρα αγγεία με μεγαλύτερη ακρίβεια .	συνεχίζουν
Ακόμα και οι επιστήμονες , βλέπετε , [MASK] κάποτε λάθη .	κάνουν
Τα συνεργεία καθαρισμού [MASK] μέχρι αργά χθες το βράδυ έντονες προσπάθειες για να καθαρίσουν το χιόνι , χωρίς όμως να καταφέρουν να αποκαταστήσουν την κυκλοφορία , με αποτέλεσμα να παραμένουν εγκλωβισμένα χιλιάδες αυτοκίνητα και φορτηγά .	κατέβαλαν
Έπειτα από πολύωρες μάχες με την προεδρική φρουρά [MASK] υπουργούς , μεταξύ των οποίων τον υπουργό Εξωτερικών Σουμεϊλού Μπουμπέγε Μάιγκα .	συνέλαβαν
Ο πρόεδρος θα [MASK] την εξουσία μετά τις εκλογές του επόμενου μήνα .	εγκατέλειπε
Όλα αυτά έχουν [MASK] προβληματισμό , ωστόσο ο Επίτροπος Nielson αντιμετωπίζει τα προβλήματα αυτά αρκετά δυναμικά .	προκαλέσει
Η Σύμβαση Λομέ [MASK] τα προβλήματά της .	είχε
Θα πρέπει να [MASK] πολυμερή βοήθεια ή διμερή βοήθεια ;	χρησιμοποιήσουμε
Όλα αυτά τα στοιχεία θα πρέπει να [MASK] την εταιρική σχέση .	ισχυροποιήσουν
Εάν θέλουμε πραγματικά να δώσουμε ένα τέλος σ την οικονομική μετανάστευση και σ την παγκόσμια τρομοκρατία , θα πρέπει να [MASK] ένα επίπεδο διαβίωσης σ τις αναπτυσσόμενες χώρες που θα πείσει τους ανθρώπους να παραμείνουν και να εργαστούν εκεί .	προσφέρουμε
Τον περασμένο μήνα οι τουρκικές αρχές [MASK] το διαβατήριο του Φετουλάχ Γκιουλέν , ο οποίος βρίσκεται σ τις ΗΠΑ με άδεια παραμονής ( Πράσινη Κάρτα ) .	ακύρωσαν
Η έκτασή του [MASK] τα 74 τετραγωνικά χιλιόμετρα .	φτάνει
Οι λόφοι και οι κοιλάδες του [MASK] ελαιόδεντρα και είναι κατάφυτες , γεγονός που διαφοροποιεί το τοπίο , κατά πολύ , σε σχέση με τα άλλα νησιά του Αιγαίου , όπου η βλάστηση είναι σχεδόν ανύπαρκτη .	έχουν
Το 1965 , η Χώρα [MASK] ολοκληρωτική καταστροφή όταν χτυπήθηκε από έναν μεγάλο σεισμό .	υπέστη
Η Παλιόπορτα ή Kαζάρμα [MASK] την είσοδο της μεσαιωνκής οχύρωσης .	αποτελεί
Σήμερα , το Πατητήρι [MASK] το εμπορικό και διοικητικό κέντρο της Αλοννήσου .	αποτελεί
Λίγο βορειότερα από το λιμάνι [MASK] τους οικισμούς Ρουσούμ - Γιαλό και Βότση , οι οποίοι είναι χτισμένοι σε δύο πανέμορφους όρμους .	συναντάμε
Από το Πατητήρι , καΐκια [MASK] εκδρομές και θαλάσσιες περιηγήσεις σ τις γειτονικές παραλίες καθ' όλη τη διάρκεια της ημέρας .	πραγματοποιούν
Σ την Ουάσιγκτον , ο Λευκός Οίκος [MASK] ικανοποίηση για την απόφαση της Πιονγκγιάνγκ , χαρακτηρίζοντας την « θετικό πρώτο βήμα » , αλλά τόνισε ότι « οι ΗΠΑ περιμένουν τώρα να δουν όχι μόνο λόγια αλλά και έργα απ' τη Βόρεια Κορέα » .	εξέφρασε
Ο υπουργός ΠΕΧΩΔΕ Γιώργος Σουφλιάς , συνοδευόμενος από τον υπουργό Αγροτικής Ανάπτυξης Σωτήρη Χατζηγάκη , [MASK] την Ήπειρο και παρέδωσε δύο σημαντικά τμήματα της Εγνατίας από σήραγγα Δρίσκου μέχρι τον κόμβο του Αράχθου μήκους 2,5 χλμ. , που περιλαμβάνει και τη γέφυρα Αράχθου και από Κόμβο Μετσόβου μέχρι Κόμβο Παναγιάς - Έξοδος προς Θεσσαλία μήκους 15 χλμ.	επισκέφθηκε
Ουσιαστικά , με αυτά τα δύο τμήματα , η Εγνατία Οδός [MASK] κάθετα την οροσειρά της Πίνδου , ενώνοντας την Ανατολική με τη Δυτική Ελλάδα .	διασχίζει
Η μεγαλύτερη του Δρίσκου [MASK] μήκος 4.563 μέτρα και ακολουθεί η σήραγγα Μετσόβου μήκους 3.570 μέτρων .	έχει
« Μέχρι τώρα [MASK] πολλές επιλογές .	εξετάζουμε
. ( ES ) Κύριε Πρόεδρε , ως εκπρόσωπος της Προεδρίας του Συμβουλίου της Ένωσης , [MASK] την αρμοδιότητα να παρέμβω εν συντομία σχετικά με αυτά τα θέματα Δικαιοσύνης και Εσωτερικών Υποθέσεων .	έχω
Η ισπανική Προεδρία , από την έναρξή της , [MASK] τη δέσμευσή της να συνεργαστεί στενά με το Ευρωπαϊκό Κοινοβούλιο , όπως επιβεβαίωσαν σ τις εμφανίσεις τους ενώπιον του Κοινοβουλίου ο Πρόεδρος του Συμβουλίου , ο Πρόεδρος της ισπανικής κυβέρνησης , ο πρώτος Αντιπρόεδρος της κυβέρνησης και Υπουργός Εσωτερικών και ο Υπουργός Δικαιοσύνης σ την Επιτροπή Ελευθεριών και Δικαιωμάτων των Πολιτών .	επανέλαβε
Το περιεχόμενο αυτής της έκθεσης Watson , την οποία η Προεδρία συμμερίζεται , [MASK] το απαραίτητο πολιτικό περιβάλλον για να μπορέσει η Ευρωπαϊκή Επιτροπή , η οποία εργαζόταν πολύ καιρό ήδη για την προετοιμασία των αποφάσεων-πλαίσιο σχετικά με την καταπολέμηση της τρομοκρατίας και το ευρωπαϊκό ένταλμα σύλληψης , να παρουσιάσει επειγόντως , μετά τις 11_Σεπτεμβρίου , και τα δύο νομοθετικά σχέδια , τα οποία μπόρεσαν να αποτελέσουν αντικείμενο συμβιβασμού σ το Συμβούλιο Δικαιοσύνης και Εσωτερικών Υποθέσεων σ τις 6 και 7_Δεκεμβρίου και τα οποία επικυρώθηκαν πολιτικά σ το Ευρωπαϊκό Συμβούλιο του Λάκεν .	δημιούργησε
Το Ευρωπαϊκό Κοινοβούλιο μόλις [MASK] την έκθεση σχετικά με τις δύο αυτές αποφάσεις με εξαιρετικά υψηλό επίπεδο τεχνικής ικανότητας και πολιτικής ευαισθησίας .	παρουσίασε
Όπως ήδη είπα , η Ευρωπαϊκή Επιτροπή [MASK] εδώ και καιρό τα σχέδια και μπόρεσε να τα παρουσιάσει αμέσως μετά τις τρομοκρατικές επιθέσεις της 11ης_Σεπτεμβρίου , χάρη σ το έργο που είχε επιτελέσει προηγουμένως .	μελετούσε
Όσον αφορά τη λίστα των τρομοκρατικών οργανώσεων , η ισπανική Προεδρία [MASK] τη δυσαρέσκεια που προκάλεσε σ' αυτή την Αίθουσα η υιοθέτηση από το Συμβούλιο , σ τις 27_Δεκεμβρίου , υπό τη βελγική Προεδρία , μίας λίστας τρομοκρατικών οργανώσεων , που σχετίζεται στενά με τον κανονισμό ( ΕΚ ) αριθ. 2580/2001 , χωρίς να υπάρχει προηγούμενη διαβούλευση με το Ευρωπαϊκό Κοινοβούλιο , το οποίο είχε εκφράσει την επιθυμία του να αποφανθεί σχετικά με αυτό το ζήτημα .	γνωρίζει
Αυτός ο κατάλογος [MASK] μέρος , μέχρι την 1η_Ιουνίου_2001 , του εγγράφου " Απειλή " της Προεδρίας , εμπιστευτικού χαρακτήρα , το οποίο δεν συζητήθηκε ποτέ με το Ευρωπαϊκό Κοινοβούλιο .	αποτελούσε
Η ευρωπαϊκή κοινή γνώμη [MASK] από μας μία ταχεία , ορατή και αποφασιστική δράση σ την καταπολέμηση της τρομοκρατίας .	απαιτούσε
Η παρουσία του πρώτου Αντιπροέδρου της Κυβέρνησης και Υπουργού Εσωτερικών και του Υπουργού Δικαιοσύνης της Προεδρίας αυτές τις τελευταίες εβδομάδες σ' αυτή την Αίθουσα [MASK] τη βούληση της Προεδρίας να εργαστεί με το Ευρωπαϊκό Κοινοβούλιο .	υπογραμμίζουν
Τέλος , όσον αφορά τον ορισμό της τρομοκρατικής πράξης , το κείμενο της κοινής θέσης 01/931 [MASK] το περιεχόμενο της απόφασης-πλαίσιο του Συμβουλίου , για την οποία έχουν γίνει διαβουλεύσεις με το Κοινοβούλιο .	επαναλαμβάνει
Κύριε Πρόεδρε , η καθιέρωση του ευρώ ως μετρητό χρήμα δεν [MASK] μόνο διαχειριστική και οργανωτική επιτυχία , αλλά συμβάλλει πραγματικά ήδη σήμερα σ την καλύτερη διαμόρφωση και εξεύρεση της ευρωπαϊκής ταυτότητας και αυτό δεν μπορούν να το αλλάξουν οι ευρωσκεπτικιστές της Ιταλίας .	αποτελεί
Η λέξη ευρώ θα [MASK] κατά την άποψή μου την πιο θετική λέξη του έτους 2002 .	αποτελέσει
Σε τελική ανάλυση , το ευρώ [MASK] τη δυναμική και την αποφασιστικότητα της Ευρώπης να δημιουργήσει μια ευρωπαϊκή ταυτότητα , να βελτιώσει την ευρωπαϊκή ανταγωνιστικότητα προς όφελος της οικονομίας και της απασχόλησης και να συνενωθεί σε μια μόνιμη κοινότητα αλληλεγγύης .	ενσαρκώνει
Η Νομισματική Ένωση [MASK] την εσωτερική αγορά - που αποτελεί τη σωστή απάντηση σ τις προκλήσεις της παγκοσμιοποίησης - και την καθιστά ωφέλιμη για όλους - για τις μικρές και μεσαίες επιχειρήσεις και προπάντων για τους πολίτες .	ολοκληρώνει
Η επιτυχία της έναρξης της κυκλοφορίας του ευρώ με τη μορφή μετρητού χρήματος έχει [MASK] τους πάντες και έχει δημιουργήσει ένα κλίμα αισιοδοξίας , το οποίο χρειαζόμαστε επειγόντως σ την Ευρώπη προκειμένου να αυξηθούν οι επενδύσεις , να αναθερμανθεί η ζήτηση σ την εσωτερική αγορά και να ενισχυθεί η απασχόληση .	ενθουσιάσει
Η καθιέρωση του ευρώ [MASK] επιστέγασμα και ανταμοιβή των συνεχών προσπαθειών που έγιναν σ την πορεία προς τη Νομισματική Ένωση .	αποτελεί
Τα τρία χρόνια της Νομισματικής Ένωσης μας [MASK] ένα παρόμοια σταθερό νομισματικό μέλλον .	υπόσχονται
Κατά συνέπεια , η Νομισματική Ένωση [MASK] αυτά που είχε υποσχεθεί από πολιτική άποψη η Συνθήκη του Μάαστριχτ , ότι δηλαδή θα οδηγήσει σ τη σταθερότητα των τιμών .	τήρησε
Εδώ δεν πρέπει όμως να [MASK] το εξής : το ευρώ δεν είναι μόνο ένα νομισματικό πρόγραμμα , αλλά ήταν ανέκαθεν και πολιτικό πρόγραμμα , αποτελώντας τμήμα της Πολιτικής Ένωσης της Ευρώπης .	ξεχάσουμε
Επιπλέον , το ευρώ [MASK] την ικανότητα των Ευρωπαίων να οργανώνουν τα κοινά τους στοιχεία προς δικό τους όφελος , προς όφελος όλων των ευρωπαϊκών κρατών .	αποδεικνύει
Εμείς , ως Κοινοβούλιο , [MASK] την ανεξαρτησία της Ευρωπαϊκής Κεντρικής Τράπεζας , αλλά ταυτόχρονα και την υποχρέωσή της να λογοδοτεί .	υποστηρίξαμε
Η υποχρέωση αυτή [MASK] διαφανή και εύληπτη τη νομισματική πολιτική και συμβάλλει σ τη διερεύνηση αυτού του μυστηρίου , δεδομένου ότι η νομισματική πολιτική δεν είναι ουδέτερη αλλά επηρεάζει και την πραγματική οικονομία , την ανάπτυξη και την απασχόληση .	καθιστά
Οι εν λόγω φαρμακοβιομηχανίες έχουν ήδη [MASK] δισεκατομμύρια δολάρια τα τελευταία χρόνια σε έρευνες για νέα φάρμακα με στόχο την αύξηση των κερδών τους και τη διατήρηση της ανταγωνιστικότητάς τους έναντι άλλων φαρμακοβιομηχανιών .	ξοδέψει
Τα ερευνητικά συμπεράσματα της ομάδας και οι σχετικές της αναλύσεις θα είναι [MASK] σ το ευρύτερο κοινό , προσφέροντας έτσι πρόσβαση και σε άλλους ερευνητές να μελετήσουν στοιχεία που θα μπορούσαν να χρησιμοποιηθούν για περαιτέρω έρευνες και ανάπτυξη νέων φαρμάκων .	διαθέσιμα
Αν και η Συνθήκη του Μάαστριχτ παρέσχε το 1992 σ το Σώμα την εξουσία της συναπόφασης όσον αφορά τέτοιου είδους νομοθεσία δεν του [MASK] την εξουσία να εποπτεύει αποτελεσματικά το ρόλο οποιασδήποτε επιτροπής .	παρέσχε
Για πρώτη φορά σ τη νομοθεσία της ΕΕ , θα [MASK] μια ρήτρα λήξης που θα αφαιρέσει τις αρμοδιότητες της Επιτροπής και της επιτροπής μετά από τέσσερα χρόνια , αν αυτές δεν χρησιμοποιηθούν συνετά και καλά .	έχουμε
Η συμφωνία θα [MASK] το ευρώ - γιατί τι είναι το ενιαίο νόμισμα αν οι αγορές σ τις οποίες κυκλοφορεί χωρίζονται ακόμη από εθνικούς φραγμούς ;	στηρίξει
Η Κατερίνα μου [MASK] ένα πλάγιο βλέμμα και κρυφογελάει , αλλά το « κρυφό » είναι σχήμα λόγου , γιατί της Αδριανής δεν της ξεφεύγει τίποτα .	ρίχνει
Τώρα , αν εγώ θέλω να παραιτηθώ , επειδή είμαι ξεροκέφαλος ή μη μου άπτου , [MASK] δικό μου θέμα .	είναι
Ο Φάνης μου [MASK] αμίλητος το χέρι και με χτυπάει σ την πλάτη σαν να θέλει να μου δώσει κουράγιο .	σφίγγει
Εδώ και χρόνια [MASK] τους υφισταμένους μου πάντα εκ περιτροπής , για να αποφύγω τα προνόμια και μαζί τις κόντρες μεταξύ τους .	παίρνω
Ως εδώ τα επιχειρήματα που επικαλούμαι [MASK] εμένα και το χαρακτήρα μου .	αφορούν
« Με τη φωτιά θα [MASK] την ασφάλεια » .	πάρουμε
Αν δε διαβάζουν , τότε γιατί ν' [MASK] την εφημερίδα ;	αγοράσουν
« Όπως βλέπετε , [MASK] μια σύσκεψη με τους συνεργάτες μου » της απαντώ .	έχω
Ο υπάλληλος σ την είσοδο [MASK] το κεφάλι του , όταν μαθαίνει το σκοπό της επίσκεψής μας .	κουνάει
Ο Δημητρίου έχει [MASK] ήδη οδηγίες σ το συνεργείο της σήμανσης για να πιάσει δουλειά .	δώσει
Μόλις βγαίνω από το ασανσέρ , [MASK] ένα βουητό από φωνές .	ακούω
« Χτες το μεσημέρι [MASK] μια σύσκεψη , που τελείωσε γύρω σ τις τρεις » .	είχαμε
Η μία έχει [MASK] τρία λιμάνια .	πάρει
« Ναι , ο άντρας σου [MASK] έναν άνθρωπο και είναι σ τη φυλακή » της εξηγεί η Κούλα , γιατί δεν έχει πια νόημα να της το κρύψει .	σκότωσε
Ο μπαμπάς του [MASK] ένα περιβόλι και φύτευε κρεμμυδάκια και μαρούλια .	είχε
Εγώ και κάτι άλλοι σαν εμένα [MASK] μια ζωή για να την καταργήσουμε , αλλά κάποιοι την έκαναν μόδα και ξεμπέρδεψαν μαζί της .	φάγαμε
« Αν δω ότι δεν περισσεύει για το βράδυ , θα [MASK] λίγο αρακά » .	φτιάξω
Όταν τον ρώτησα πώς είναι δυνατό να συνεργάζονται οι δυο μαφίες , που οι χώρες τους είναι σ τα μαχαίρια , [MASK] τα γέλια .	έβαλε
Λίγο πριν φτάσουμε , ο Γκίκας [MASK] τη σιωπή του .	σπάει
« Αφού δεν [MASK] ακόμα στοιχεία , γιατί πιστεύετε ότι ο Λαλόπουλος εμπλέκεται σε λαθρεμπόριο ; »	έχετε
Σ τη ζωή μου όμως δεν [MASK] ποτέ τους μάγους με τα δώρα να μας πέφτουν από τον ουρανό .	είδα
« Εντάξει , [MASK] μια επιφύλαξη , γιατί ο υπουργός θα κάνει σήμερα δηλώσεις σχετικά με την επιστροφή των ναυτιλιακών εταιρειών σ τη μητέρα πατρίδα » .	κρατάω
Σαν να μη μου έφτανε η κούραση , [MASK] και το στομάχι μου ασήκωτο .	νιώθω
« Εγώ , κόρη μου , [MASK] μια απλή νοικοκυρά » .	είμαι
Μόλις και μετά βίας μας [MASK] μισή καλημέρα .	λέει
« Αλλά θα [MASK] την κηδεία του πατέρα σας σ το Λονδίνο ; »	κάνετε
Εξάλλου , ούτε η γυναίκα [MASK] απάντηση , πιο πολύ μοιρολογάει την απουσία του .	περιμένει
Παρά τη γκρίνια της έχει [MASK] και κρασί , για να γιορτάσουμε τις αυξήσεις , που είναι ένα είδος γενεθλίων .	φέρει
Και τα πενήντα χιλιάρικα που βρέθηκαν άθικτα [MASK] αυτήν την εκδοχή .	ενισχύουν
« Όσο η υπόθεση της δολοφονίας έμενε ανοιχτή , [MASK] και τις δικές μας έρευνες » .	διευκόλυνε
Ο αστυνομικός που φυλάει την είσοδο , [MASK] την κόκκινη ταινία και μας ανοίγει την πόρτα	σηκώνει
« Για να [MASK] σάκο » .	κλέψω
Κάτω από τη φωτογραφία , ο Σωτηρόπουλος έχει [MASK] μια σημείωση :	προσθέσει
« Τώρα κανείς δε θα [MASK] ούτε το δάχτυλό του , γιατί κανείς δεν έχει λόγο να είναι δυσαρεστημένος » .	κουνάει
« Η δική μου τα [MASK] όλα σ' εσάς , τους δεξιούς δωσίλογους » .	φόρτωνε
« Σ την υπηρεσία που με φέρατε , [MASK] κάθε μέρα και μια έκπληξη » .	έχω
Αντί για το σπίτι , [MASK] πλώρη για το γραφείο της κόρης μου .	βάζω
Μόλις καταπίνω την πρώτη γουλιά από τον καφέ μου , [MASK] το τηλέφωνο και είναι ο Δημητρίου .	χτυπάει
« Ποιος τρελός [MASK] τον Μένη ; »	σκότωσε
Το ΚΕΑΝ δεν [MASK] κανένα πρόγραμμα , δεν ανέλαβε καμία δέσμευση και δεν έδωσε καμία υπόσχεση .	παρουσίασε
« Καλά , εσύ [MASK] τάμα » .	έκανες
Ούτε η πόρτα του οδηγού ούτε η τέντα του [MASK] κάποιο σήμα εταιρείας , ή έστω διαφήμιση με κάποιο τηλέφωνο , ώστε να πιαστούμε από κάπου .	έχουν
Το δείπνο θα [MASK] χώρα σ το ιταλικό , που είχαμε φάει και σ την προηγούμενη έξοδό μας .	λάβει
« Όλες οι προηγούμενες [MASK] ψαλίδι σ τους μισθούς μας η μια μετά την άλλη » .	έβαζαν
Αν είχαν χωρίσει κανονικά , θα είχαν [MASK] και το παιδικό δωμάτιο σ την καινούρια κατοικία της μητέρας .	μεταφέρει
Ως τώρα οι ευρωπαϊκές εταιρείες [MASK] θυγατρικές εταιρείες σ την Ελλάδα .	άνοιγαν
« Μη μου [MASK] συγχαρητήρια , γιατί την έφτιαξε ο Λάμπρος » μας ανακοινώνει η Αδριανή .	δώσετε
Μόλις μπαίνει , μου [MASK] την καθιερωμένη ερώτησή του .	κάνει
Σ το μεταξύ [MASK] τηλέφωνο έναν γνωστό μου σ την τροχαία .	παίρνω
« Οι πληροφορίες που συγκέντρωσες δεν [MASK] πεντακόσιες χιλιάδες δολάρια , άρα είναι κρατικό μυστικό και δεν αποκαλύπτονται » μου εξηγεί .	αξίζουν
Ευτυχώς που έχω να κάνω με ξύπνιο Γερμανό , γιατί δεν [MASK] καμία ερώτηση .	κάνει
Και όταν ο μπαμπάς μεταφέρθηκε σ τη δευτέρα παρουσία , [MASK] και ο γιος την επιχείρηση σ την Ελλάδα .	μετέφερε
Μετά , εγώ [MASK] ένα ραντεβού σ το υπουργείο Ναυτιλίας , που κράτησε ως αργά και δεν επέστρεψα σ το γραφείο .	είχα
« Συνεπώς δε θα [MASK] τίποτα σ την Κατερίνα » .	πεις
Συνήθως τα καΐκια [MASK] σ' εμάς ψάρια , που τα πουλάνε σ το μόλο και σ την παραλία .	φέρνουν
Κάθε φορά που παίρνω την απόφαση να χαλαρώσω , [MASK] ο διάολος το πόδι του και μου τα χαλάει .	βάζει
« Η Τζέιν Όγκντεν [MASK] ένα εξοχικό σ το Δήλεσι » .	έχει
« Αλλά αυτό [MASK] τα δεδομένα της δολοφονίας του » .	αλλάζει
Στραβόξυλο και γραφειοκράτης [MASK] σετάκι , λέω μέσα μου .	πάνε
« Εντάξει , [MASK] πολλά , αλλά υπάρχει μια διαφορά » της απαντάει η Κατερίνα .	περάσαμε
Με την τρίτη [MASK] το τζιπ , ώσπου βουλιάξαμε .	παίρναμε
Η ανομία και η αταξία [MASK] την προσοχή των ξένων πάνω σ τη χώρα και αυτό δε μας συμφέρει , γιατί εμείς δε θέλουμε να βγαίνουμε από το περιθώριο .	στρέφουν
« Και πού θα [MASK] τα λεφτά για ν' αγοράσετε ; »	βρείτε
Ο Ζήσης μού έχει [MASK] το μυαλό και νιώθω ήρεμος .	καθαρίσει
« Γιατί μας [MASK] την έρευνα » .	σταμάτησαν
« Αυτά τα δυο ρεμάλια [MASK] φασαρία , γιατί βρήκαν τα μπιφτέκια τους άψητα » .	κάνανε
Από την άλλη , [MASK] τόσο βάρος σ' αυτά που είπε ο Ούλι ;	δίνω
Μόλις ανεβαίνω σ το γραφείο , με τον καφέ και το κρουασάν μου , [MASK] τηλέφωνο τον Σωτηρόπουλο , να τον ευχαριστήσω για τη συνάντηση με τον Κυριαζίδη .	παίρνω
« Όταν μας ζορίζει , θα σας [MASK] τηλέφωνο » της λέει .	παίρνω
« Όχι , [MASK] πολεμικό συμβούλιο » του απαντάει η Μάνια και του εξηγεί εν συντομία την κατάσταση .	έχουμε
Όλα αυτά έχουν [MASK] ακόμα και την πείνα μου .	διαγράψει
Η ώρα έχει [MASK] δέκα .	πάει
« Όταν ήρθε να σας το δώσει , [MASK] κάτι διαφορετικό σ τη συμπεριφορά του ; »	παρατηρήσατε
Εξάλλου , δε σου 'χω [MASK] καμιά σπουδαία αποκάλυψη .	κάνει
« Κύριε αστυνόμε , [MASK] τηλέφωνο από τον Πειραιά για να δηλώσουν μια δολοφονία » .	πήραν
Ως συνήθως , του τα [MASK] όλα με κάθε λεπτομέρεια .	λέω
Κι εγώ δε [MASK] σχόλια πίσω από την πλάτη μου σε ένα ανδροκρατούμενο σώμα .	θέλω
« Αν έφευγα , θα [MASK] την υπόλοιπη ζωή μου σ τη σύνταξη με την πίκρα ότι ένα στραβάδι κατάφερε να με στείλει σ το σπίτι μου » .	ζούσα
Η φύση του προβλεπόμενου μέσου [MASK] μόνο τις κατασταλτικές πτυχές του φαινομένου των ναρκωτικών .	αφορά
Επομένως , η μελέτη αυτή , που δημοσιοποιήθηκε , [MASK] τη συγκριτική ανάλυση της νομοθεσίας όλων των κρατών μελών σε θέματα διακίνησης ναρκωτικών .	επέτρεψε
ή σ το μεγαλύτερο μέρος των περιπτώσεων ναρκωτικών η διακίνηση [MASK] εξωευρωπαϊκή καταγωγή και είναι πάντα διεθνής , ή δεν κατανοώ πώς είναι δυνατό να θέλουμε να τιμωρήσουμε πιο αυστηρά τη διασυνοριακή διακίνηση από τη σοβαρή διακίνηση που πραγματοποιείται σ το εσωτερικό κάθε κράτους μέλους .	έχει
Από την άποψη αυτή , η Επιτροπή [MASK] επικρίσεις για έλλειψη φιλοδοξίας .	δέχθηκε
Αλλά εδώ - τρίτη σημαντική παρατήρηση - [MASK] την αρχή της επικουρικότητας .	σεβαστήκαμε
Το ελάχιστο όριο των πέντε ετών για τη μέγιστη ποινή όχι μόνο [MASK] μεγάλο περιθώριο ελιγμού για να εφαρμόσουν οι δικαστές το νόμο σε συνάρτηση με τις περιστάσεις κάθε περίπτωσης παράνομης διακίνησης , αλλά επίσης είναι μια πρόταση που αποσκοπεί να δώσει μια ιδέα της αυστηρότητας με την οποία επιδιώκουμε να τιμωρούνται οι περιπτώσεις διακίνησης ναρκωτικών σ τις οποίες εφαρμόζεται η ποινή αυτή .	προσφέρει
Και που , όπως υπογράμμισε ο κ. Oostlander , [MASK] πηγή χρηματοδότησης πολυάριθμων άλλων εγκληματικών δραστηριοτήτων , μεταξύ των οποίων και της ίδιας της τρομοκρατίας .	αποτελεί
Πλούσια βλάστηση και ορεινά μονοπάτια μοναδικής φυσικής ομορφιάς [MASK] μία μαγευτική εικόνα σ το όρος Παγγαίο : δάση από καστανιές , οξιές , κέδρους και έλατα και ανάμεσά τους τρεχούμενα νερά και αγριολούλουδα , όπως η " παιόνια " ή αλλιώς " τουλίπα του Παγγαίου " .	συνθέτουν
Ο Άγιος Χριστόφορος , [MASK] το νεότερο οικισμό , σ τις παρυφές του Παγγαίου , ο οποίος χτίστηκε από την επιθυμία των κατοίκων να βρίσκονται κοντύτερα σ τον κάμπο .	αποτελεί
Σ τον ίδιο δρόμο [MASK] και το χωριό Αυλή , από το οποίο ξεκινάει ορειβατικό μονοπάτι που διασχίζει ολόκληρο το Παγγαίο σε μια διαδρομή περίπου τεσσάρων ωρών .	συναντάμε
Οι παραδοσιακές πλατείες και τα στενά δρομάκια με την ντόπια μακεδονική αρχιτεκτονική [MASK] όλα τα χωριά του Παγγαίου .	χαρακτηρίζουν
Κυρία Πρόεδρε , η έκρηξη του ηφαιστείου Νιραγκόνγκο [MASK] δύο πραγματικότητες , οι οποίες συνιστούν πρόκληση για τη διεθνή κοινότητα εν γένει και , πιο συγκεκριμένα , για την Ευρωπαϊκή Ένωση και για τις χώρες της περιοχής .	αποκάλυψε
Ωστόσο , όλη αυτή η στρατηγική δεν θα [MASK] χρήσιμα αποτελέσματα , αν δεν εδραιωθούν σ τη χώρα τα θεμέλια ενός δημοκρατικού καθεστώτος με ευρεία κοινωνική συναίνεση , που θα εγγυάται τη σταθερότητα και την ειρήνη .	έχει
Αμέσως μετά την απελευθέρωση της Ελλάδας από τους γερμανούς κατακτητές , η κυβέρνηση εθνικής ενότητας του Γεωργίου Παπανδρέου [MASK] το δύσκολο έργο της αντιμετώπισης του μεγάλου οικονομικού προβλήματος που άφησε πίσω του ο Β' Παγκόσμιος Πόλεμος .	ανέλαβε
Επιχειρώντας να διαμαρτυρηθεί για τις εξελίξεις , το Ε.Α.Μ. [MASK] συγκέντρωση διαμαρτυρίας σ τις 3_Δεκεμβρίου_1944 σ την πλατεία Συντάγματος .	διοργάνωσε
Κατά το ΕΑΜ , 28 άνθρωποι [MASK] τη ζωή τους ( οι 21 σ το Σύνταγμα ) και 140 τραυματίστηκαν .	έχασαν
ΗΠΑ και Φιλιππίνες [MASK] στρατιωτική συμφωνία με την ευκαιρία της επίσκεψης Ομπάμα σ τη χώρα .	υπέγραψαν
Η Κίνα και οι Φιλιππίνες [MASK] θαλάσσιες και εδαφικές διαφορές , σε περιοχή της Θάλασσας της Νότιας Κίνας .	έχουν
Το κινεζικό κρατικό πρακτορείο ειδήσεων Ζινχουά [MASK] τη συμφωνία με τις Φιλιππίνες " ιδιαίτερα ανησυχητική , δεδομένου ότι μπορεί να αλλάξει τον τρόπο που η Μανίλα αντιμετωπίζει το Πεκίνο . "	αποκάλεσε
Το κλείσιμο των βάσεων είχε [MASK] το τέλος της αμερικανικής στρατιωτικής παρουσίας σ τις Φιλιππίνες σχεδόν μετά από έναν αιώνα .	σηματοδοτήσει
Αυτό σε παραλληλισμό με τους ανταγωνισμούς μεταξύ των νικητριών δυνάμεων που είχαν αρχίσει να αναπτύσσονται και συμπληρωμένο από το βαθμιαίο πέρασμα των ταγμάτων ασφαλείας και των λοιπών δοσιλογικών οργανώσεων σ το πλευρό της δεξιάς [MASK] τα δύο στρατόπεδα .	διαμόρφωσε
Η διακίνηση αλληλογραφίας μέσω ταχυδρομείων έχει [MASK] κάθετη πτώση σ τις ΗΠΑ λόγω της χρήσης ηλεκτρονικών μηνυμάτων και του διαδικτύου για επικοινωνία .	σημειώσει
Σ τα 356 π.Χ. κάτω από την απειλή των Θρακών , οι κάτοικοι [MASK] τη βοήθεια του Φιλίππου Β΄ , ο οποίος , διαβλέποντας την οικονομική και στρατηγική σημασία της πόλης , την καταλαμβάνει , την οχυρώνει και την μετονομάζει σε Φιλίππους .	ζητούν
Σ τη Ρωμαϊκή αυτοκρατορία , η πόλη [MASK] ιδιαίτερη εμπορική σημασία λόγω της Εγνατίας Οδού , η οποία συνέδεε το Δυρράχιο με το Βυζάντιο .	απέκτησε
Η Σπόρτινγκ Λισαβόνας [MASK] την Μάντσεστερ Σίτι με σκορ 1:0	νίκησε
Η Σπόρτινγκ Λισαβόνας [MASK] την Μάντσεστερ Σίτι με σκορ 1:0 , σ τα πλαίσια της φάσης των 16 του Γιουρόπα Λιγκ 2011-2012 .	νίκησε
Σ το 51ο λεπτό , ο τερματοφύλακας της Μάντσεστερ Σίτι , Τζο Χάρτ , [MASK] την εκτέλεση φάουλ του Ξαντάο , αλλά ο Βραζιλιάνος κατάφερε να σπρώξει την μπάλα σ τα δίκτυα .	απέκρουσε
Κατά τη διάρκεια του 1959 η κυβέρνηση Κάστρο [MASK] δημοφιλή μέτρα , όπως η ανακατονομή της γης , η κρατικοποίηση οργανισμών κοινής ωφελείας και ο αδίστακτος πόλεμος κατά της διαφθοράς , συμπεριλαμβανομένων του κλεισίματος της βιομηχανίας τζόγου και της εκδίωξης των Αμερικανών μαφιόζων .	πήρε
Ενώ η κυβέρνηση του Αϊζενχάουερ αρχικά καλωσόρισε την πτώση του Μπατίστα , η κρατικοποίηση εταιρειών που ανήκαν σε βορειοαμερικανούς ( με εκτιμημένη αξία 1 δισ. δολάρια ΗΠΑ ) και η εκδίωξη πολλών συντηρητικών με ισχυρούς φίλους σ τις ΗΠΑ [MASK] εχθρότητα και οι Κουβανοί εξόριστοι έγιναν γρήγορα μια ισχυρή ομάδα λόμπι σ τις ΗΠΑ , ισχύ την οποία διατηρούν μέχρι σήμερα .	δημιούργησαν
Αυτό με τη σειρά του , [MASK] τον Κάστρο να απομακρυνθεί από οποιαδήποτε φιλελεύθερα στοιχεία που υπήρχαν σ το επαναστατικό του κίνημα και να στραφεί προς τους κομουνιστές .	ώθησε
Με φόντο τον Ψυχρό Πόλεμο , οι ΗΠΑ [MASK] ανεπίτρεπτη την επιρροή των Σοβιετικών σ την αμερικανική ήπειρο και εγκρίθηκαν σχέδια για απομάκρυνση του Κάστρο από την εξουσία .	θεώρησαν
Την ίδια ώρα , η αμερικανική κυβέρνηση [MASK] σχέδια για εισβολή σ την Κούβα από εξόριστους που είχαν ως βάση τη Φλόριντα με ταυτόχρονο εσωτερικό ξεσηκωμό εναντίον του Κάστρο .	εξουσιοδότησε
Δύο απ' τους ομήρους δεν [MASK] τίποτα , ενώ ένας μεγαλομέτοχος της εταιρείας και ένας Βούλγαρος εργάτης τραυματίστηκαν απ' τον οπλισμένο άνδρα .	έπαθαν
Τα πεύκα που φτάνουν ως τη θάλασσα , μαζί με τις ελιές , τις φλαμουριές , τα πλατάνια και τις ψηλές βουνοκορυφές [MASK] τοπία εκπληκτικής ομορφιάς .	συνθέτουν
Ένα ακόμα μουσείο , που βρίσκεται σ την Ποταμιά , το μουσείο Πολύγνωτου Βαγή , [MASK] γλυπτά του θάσιου καλλιτέχνη .	φιλοξενεί
Τα μικρά χωριά ως επί το πλείστον χτισμένα σ τις βουνοπλαγιές , [MASK] έκπληξη για τον επισκέπτη .	αποτελούν
Οι ναοί - επηρεασμένοι από την αρχιτεκτονική του Αγίου Όρους - , τα λιοτρίβια , οι νερόμυλοι και οι βρύσες [MASK] το παραδοσιακό χρώμα του νησιού και συνθέτουν ένα σκηνικό που μαγεύει .	διατηρούν
Σ το πρώτο ημίχρονο οι Ουκρανοί [MASK] πολύ την άμυνα του Ολυμπιακού αλλά δέκα λεπτά μετά την αρχή του δευτέρου ημιχρόνου , ο Νταβίδ Φούστερ πέτυχε το μοναδικό τέρμα του αγώνα .	πίεσαν
Σ τις όχθες του , ο επισκέπτης [MASK] γκρεμισμένα μονότοξα και πολύτοξα γεφύρια , ίχνη αρχαίων πόλεων και ακροπόλεων , που όλα μαρτυρούν την πλούσια ιστορία της περιοχής .	συναντά
Η περιοχή ( ανάμεσα σ τη Σαγιάδα , το Ράγιο και την Ηγουμενίτσα ) [MASK] έναν από τους σημαντικότερους υγροβιότοπους της Ελλάδας , σ τον οποίο βρίσκουν προστασία σπάνια είδη πουλιών και λουλουδιών .	φιλοξενεί
Εικόνες από το σημείο της πρόσκρουσης [MASK] τους τραυματίες να μεταφέρονται από τα μέλη των σωστικών συνεργείων σε φορεία , καλυμμένοι με κουβέρτες , ενώ σ την πλώρη του πλοίου είναι εμφανή τα σημάδια από την πρόσκρουση .	δείχνουν
Το 1806 ο Ναπολέων Βοναπάρτης [MASK] τον τότε αυτοκράτορα της Αγίας Ρωμαϊκής Αυτοκρατορίας , Φραγκίσκο Β' , να παραιτηθεί .	αναγκάζει
Το Κογκρέσο της Βιέννης [MASK] την πολιτική της ένωσης με τελικό αποτέλεσμα την ίδρυση της Γερμανικής Ομοσπονδίας , η οποία αποτελείται από 38 γερμανικά κράτη .	συνεχίζει
Σ τα τέλη του Α' Παγκοσμίου Πολέμου και η γερμανική μοναρχία [MASK] το τέλος της .	βρίσκει
Με την συνθήκη των Βερσαλλιών οι Γερμανοί [MASK] μεγάλες εκτάσεις ( σ το σύνολο περίπου 11% ) του κράτους τους σ τη Γαλλία , το Βέλγιο , τη Τσεχοσλοβακία , τη Δανία , τη Λιθουανία και τη Πολωνία .	χάνουν
Μετά την πτώση της Γερμανικής Δημοκρατίας η Γερμανία της μορφής του Τρίτου Ράιχ [MASK] από το 1933 αυστηρή επεκτατική πολιτική :	ακολουθεί
Το 1938 ο ηγέτης της Γερμανίας , Αδόλφος Χίτλερ , [MASK] την πατρίδα του Αυστρία και εξασφαλίζει με την συμφωνία του Μονάχου την προσάρτηση της Σουδητίας ( περιοχή Γερμανόφωνων της Τσεχοσλοβακίας ) .	ενσωματώνει
Οι νικητήριες δυνάμεις ΗΠΑ , ΕΣΣΔ και Ηνωμένο Βασίλειο , όπως και η κατοπινή κατοχική δύναμη Γαλλία [MASK] σ τις κατεχόμενες ζώνες τους νέο δημοκρατικό κράτος ενώ η σταλινική Σοβιετική Ένωση ιδρύει σοσιαλιστικό κράτος .	ιδρύουν
Ο κατοπινός ψυχρός πόλεμος μεταξύ ανατολής και δύσεως [MASK] την κεντρική Ευρώπη , συμπεριλαμβάνοντας τα δύο γερμανικά κράτη με το λεγόμενο " σιδηρούν παραπέτασμα " ( βλ. Τείχος του Βερολίνου ) .	χωρίζει
Οι δυνάμεις κατοχής του Β' Παγκοσμίου Πολέμου [MASK] την χώρα , γεγονός που για την Γερμανία σημαίνει την επαναφορά της ανεξαρτησίας της .	εγκαταλείπουν
Σ τις 9_Μαΐου_1950 ο Γάλλος υπουργός Εξωτερικών Ρομπέρ Σουμάν [MASK] μια πρόταση για κοινή διαχείριση από την Γαλλία και την Δυτική Γερμανία των βιομηχανιών του άνθρακα και του χάλυβα .	υπέβαλε
Η πρόταση , γνωστή ως " Διακήρυξη του Σουμάν " , [MASK] το σχέδιο ως " το πρώτο συγκεκριμένο βήμα προς μια Ευρωπαϊκή Ομοσπονδία " .	περιέγραφε
Το 1999 το ευρώ [MASK] τα εθνικά νομίσματα σε 11 κράτη μέλη , την λεγόμενη ευρωζώνη .	αντικατέστησε
Η πρώτη ιδέα [MASK] τη συμμετοχή των πολιτών σ τη συζήτηση για το μέλλον της Ευρώπης .	αφορά
Κατόπιν , ο καθένας θα πρέπει να [MASK] τις ευθύνες του .	αναλάβει
για τούτο , [MASK] πλήρως την ιδέα σας .	υποστηρίζουμε
Σ το πνεύμα αυτό , [MASK] κάθε καλή διάθεση να συνεισφέρουμε , από κοινού με εσάς , ώστε το Κοινοβούλιο να καταστεί ουσιαστικό σημείο αναφοράς για εκατομμύρια Ευρωπαίους και Ευρωπαίες .	έχουμε
Κύριε Πρόεδρε , καταρχάς [MASK] την κ. Επίτροπο Wallstrφm και τον κ. Chris Davies για το σπουδαίο έργο που επιτέλεσαν σ τη συγκεκριμένη υπόθεση .	ευχαριστώ
Χθες , η Άρσεναλ [MASK] την Μίλαν με σκορ 3:0 , κατά τη διάρκεια του επαναληπτικού αγώνα σ τη φάση των 16 του Τσάμπιονς Λιγκ 2011-2012 .	νίκησε
Είκοσι λεπτά αργότερα , ο Ροζίτσκι [MASK] το δεύτερο γκολ ενώ δύο λεπτά πριν τη λήξη του ημιχρόνου ο Φαν Πέρσι τριπλασίασε την υπεροχή της Άρσεναλ χάρη σε πέναλτι .	πέτυχε
Αν και ηττήθηκε , η Μίλαν [MASK] την πρόκριση για την επόμενη φάση του Τσάμπιονς Λιγκ .	πήρε
Παράλληλα , η Μπενφίκα [MASK] την Ζενίτ Αγίας Πετρούπολης με σκορ 2:0 και προκρίθηκε σ την επόμενη φάση .	νίκησε
Η Λευκή Βίβλος για την ευρωπαϊκή πολιτική μεταφορών με ορίζοντα το έτος 2010 [MASK] ακριβώς τον πολίτη , τον χρήστη , σ το κέντρο των πολιτικών μας .	τοποθετεί
Επιπλέον , η Επιτροπή έχει [MASK] σ το Κοινοβούλιο διάφορα συγκεκριμένα μέτρα - ορισμένα θα τα δείτε σύντομα - που όλα συντείνουν σ την επίτευξη του ίδιου στόχου : την τροποποίηση του κανονισμού για τους χρόνους οδήγησης και ανάπαυσης , την εισαγωγή διατάξεων περιορισμού της ταχύτητας σ τα μικρά φορτηγά , την υποχρεωτική χρήση της ζώνης ασφαλείας σε όλα τα οχήματα - συγκεκριμένα και σ τα λεωφορεία - ή την καθιέρωση του ψηφιακού ταχογράφου .	παρουσιάσει
Σε διάστημα μερικών ετών οι ευρωπαϊκοί κανόνες [MASK] τη σημαντική μείωση αυτών των ρυπάνσεων που οφείλονται σ την οδική κυκλοφορία·	επέτρεψαν
Η δεύτερη πρωτοβουλία [MASK] σκοπό τη στήριξη των ευρωπαϊκών πόλεων που προωθούν μια φιλόδοξη στρατηγική βιώσιμης κινητικότητας ·	έχει
Η Επιτροπή έχει [MASK] ήδη βήματα προς την ανάπτυξη μεθοδολογιών αξιολόγησης του αντικτύπου σ την υγεία και της εφαρμογής τους σ το κοινοτικό πλαίσιο .	κάνει
Ο Υπουργός Οικονομικών [MASK] πάντως οποιαδήποτε μορφή φορολογικής αμνηστίας για να εξασφαλιστεί ο επαναπατρισμός των κεφαλαίων που διοχετεύθηκαν σ το εξωτερικό .	αποκλείει
