Το σκορ του αγώνα [MASK] ο Γουέν Ρούνι σ το 22ο λεπτό , ωστόσο οι φιλοξενούμενοι ισοφάρισαν με τον Λλορέντε σ το 44' .	άνοιξε
[MASK] οι άμαχοι σ τη Μπάμπα Αμρ της Συρίας	Αβοήθητοι
Ωστόσο , [MASK] εδώ ένα πρόβλημα ουσίας :	υπάρχει
[MASK] μία ομάδα τροπολογιών που υπέβαλαν οι συνάδελφοι της Ομάδας των Πρασίνων / Ευρωπαϊκής Ελεύθερης Συμμαχίας , που προσπαθούν να πουν ότι η έγκριση του ευρωπαϊκού εντάλματος σύλληψης εξαρτάται από τη βελτίωση συγκεκριμένων δικαστικών προτύπων σ την Ευρωπαϊκή Ένωση .	Υπάρχει
Κατά την άποψή μας , ο [MASK] δεν είναι να υπάρχουν διαρκώς όλο και περισσότερες οδηγίες , όλο και περισσότερες λεπτομέρειες , αλλά σκοπός μας είναι οι χώρες να είναι πρόθυμες να δραστηριοποιηθούν από κοινού , ούτως ώστε και οι εργοδότες να είναι σε θέση να προσφέρουν σωστές τιμές και να μην υποφέρουν από τις συνέπειες του ντάμπιγκ , που αναπτύσσεται σ τον τομέα αυτό , και φυσικά και οι εργαζόμενοι να μπορούν να εργασθούν σε σωστές συνθήκες .	σκοπός
Νίκη σ το Κάνσας [MASK] ο Ρικ Σαντόρουμ	πέτυχε
Δηλώσαμε σ τη Β. Κορέα ότι θα απαντήσουμε αν τα πυρά τους πέσουν εκτός της συνοριακής γραμμής " , [MASK] ο Υπουργός Άμυνας της Νότιας Κορέας .	δήλωσε
Από την ίδρυσή του ως το 1453 το Κάστρο το [MASK] οι Βυζαντινοί , σ τη συνέχεια ως το 1538 οι Ενετοί και ως το 1821 οι Τούρκοι , ενώ γύρω σ το 1660 πέρασε και πάλι σ τα χέρια των Ενετών .	εξουσίαζαν
Πάνω από την πύλη [MASK] μια ταράτσα με την απαραίτητη ζεματίστρα .	υπήρχε
Ωστόσο , [MASK] περισσότερα από είκοσι εκκλησάκια , ενώ σ τα χρόνια της Τουρκοκρατίας είχε χτιστεί και τζαμί χωρίς μιναρέ .	υπήρχαν
Επίσης , μέσα σ το Κάστρο [MASK] οι απαραίτητες δεξαμενές για νερό , ενώ το Νεκροταφείο βρισκόταν έξω από την πόλη .	υπήρχαν
Μόνο μέσω εκτεταμένων γνώσεων , ακόμα και σ το πεδίο των ξένων γλωσσών , θα είναι [MASK] η πρόσβασή τους σ τις ανοικτές αγορές εργασίας σ την Ευρώπη .	απρόσκοπτη
Παράλληλα με το Ευρωπαϊκό Κοινοβούλιο [MASK] και η Επιτροπή τις εξελίξεις σε σχέση με τη δίκη που διεξάγεται κατά του κόμματος HADEP ενώπιον του τουρκικού συνταγματικού δικαστηρίου .	παρακολουθεί
Θα [MASK] κανείς να πει ότι η Τουρκία βρίσκεται εν μέσω μιας έντονης συζήτησης σχετικά με την περαιτέρω εξέλιξη της μεταρρυθμιστικής της πορείας .	μπορούσε
Απασχόληση σ το εξωτερικό [MASK] οι μισοί Έλληνες σε παραγωγική ηλικία .	ψάχνουν
Ο [MASK] είναι ο 24χρονος Μοχάμεντ Μεράχ , Γάλλος υπήκοος αλγερινής καταγωγής , που φέρεται να έχει δεσμούς με την Αλ Κάιντα .	ύποπτος
Με μεγάλη πλειοψηφία [MASK] από τη Γενική Συνέλευση του Συμβουλίου της Ευρώπης σ το Στρασβούργο η έκθεση της Ολλανδής βουλευτού , κυρίας Strick , για το μεταναστευτικό σ την Ελλάδα .	εγκρίθηκε
Είναι εξαιρετικής [MASK] το γεγονός ότι αναγνωρίστηκε , αρχικά από την Επιτροπή Μετανάστευσης και εν συνεχεία από την ολομέλεια της κοινοβουλευτικής συνέλευσης , ότι " το πρόβλημα δεν είναι ελληνικό , αλλά ευρωπαϊκό , καθώς τα σύνορα της Ελλάδας είναι και σύνορα της Ευρώπης " , και ότι " η Ελλάδα δεν μπορεί μόνη της να αντιμετωπίσει το θέμα της μετανάστευσης και να την καταπολεμήσει χωρίς μεγαλύτερη αλληλεγγύη και οικονομική βοήθεια από την Ευρωπαϊκή Ένωση και τις άλλες χώρες - μέλη του Συμβουλίου της Ευρώπης " .	σημασίας
Με το σλόγκαν « Για τους πραγματικούς φίλους μετρά μόνο η εμπιστοσύνη » [MASK] εκστρατεία προώθησης του τουριστικού προϊόντος της Ελλάδος από έξι μεγάλους « tour operators » της Γερμανίας .	ξεκίνησε
Αξιότιμε κύριε Επίτροπε , αγαπητοί συνάδελφοι , [MASK] κι εγώ αρχικά να ευχαριστήσω τον εισηγητή εξ ονόματος της Ομάδας μου , επίσης δε να ευχαριστήσω τόσο εκείνον όσο και όλους τους συντάκτες γνωμοδοτήσεων των επιτροπών επειδή είχαν να αντιμετωπίσουν έναν τεράστιο όγκο εργασίας για τη συγκεκριμένη έκθεση .	θέλω
Πριν από έναν χρόνο [MASK] δημόσια ακρόαση για το συγκεκριμένο θέμα .	έγινε
Για την Ομάδα μου [MASK] , παράλληλα με ορισμένα άλλα σημαντικά θέματα που έχουν ήδη εν μέρει θιγεί , ένα κεντρικό σημείο σ το οποίο δεν μπορούμε να συμφωνήσουμε με την Επιτροπή .	υπάρχει
Την έναρξη ερευνητικής πρωτοβουλίας για τη χαρτογράφηση των λειτουργιών του ανθρώπινου εγκεφάλου [MASK] ο Αμερικανός πρόεδρος Μπαράκ Ομπάμα .	ανακοίνωσε
Μία ανακάλυψη τέτοιου βεληνεκούς θα δημιουργήσει νέες θέσεις εργασίας σ τη χώρα , [MASK] ο αμερικανός Πρόεδρος .	δήλωσε
Οι οικονομικές κυρώσεις έχουν ήδη " πλήξει σημαντικά " τη ρωσική οικονομία , [MASK] ο αμερικανός Υπουργός Οικονομικών .	δηλώνει
Αυτό είναι επειδή το κείμενο δεν περιέχει έκκληση προς τις δύο πλευρές ( αντάρτες και κυβέρνηση ) για άμεση κατάπαυση του πυρός » , [MASK] ο Γκενάντι Γκατίλοφ , Υφυπουργός Εξωτερικών της Ρωσίας .	δήλωσε
« Σύμφωνα με τις πηγές μας , ο ΟΗΕ θα θέσει το νέο σχέδιο για ψήφισμα την Δευτέρα » , [MASK] ο Γκενάντι Γκατίλοφ .	κατέληξε
[MASK] από το θρόνο της Ολλανδίας η Βεατρίκη .	Παραιτήθηκε
Τους 179 [MASK] οι νεκροί και τους 34 οι αγνοούμενοι από τον ισχυρό σεισμό που έπληξε χθες , Δευτέρα , την κεντρική Ιταλία , σύμφωνα με νεότερο απολογισμό του κέντρου συντονισμού των επιχειρήσεων διάσωσης σ την πόλη Λ'Άκουιλα .	έφτασαν
[MASK] είναι και ο αριθμός των ανθρώπων που έχουν μείνει άστεγοι , καθώς ανέρχονται περίπου σ τους 50.000 , ενώ πολλοί είναι εκείνοι που πέρασαν τη νύχτα σε στρατώνες και σχολεία .	Τεράστιος
Περισσότερα από 10.000 κτίρια έχουν υποστεί ζημιές , [MASK] η υπηρεσία Πολιτικής Προστασίας .	ανακοίνωσε
Σ το επίκεντρο του σεισμού των 5,8 βαθμών της κλίμακας Ρίχτερ [MASK] σ τις 3.32 τα ξημερώματα της Δευτέρας , η μεσαιωνική πόλη Λ'Άκουιλα , κέντρο φοιτητικό , αλλά και η γύρω ορεινή περιοχή , η οποία κατά το μεγαλύτερο μέρος της έχει , σ την κυριολεξία , σβηστεί από το χάρτη .	βρέθηκε
[MASK] ήταν σ την ατμόσφαιρα η οσμή του αερίου , καθώς έχουν σπάσει και οι αγωγοί .	Διάχυτη
Παρόλο που η συγκεκριμένη μεθοδολογία , όπως και κάθε άλλη , εξακολουθεί να εξελίσσεται , [MASK] ήδη υπεραρκετή γνώση ώστε να ξεκινήσει η εφαρμογή της τώρα .	υπάρχει
Πραγματικά , δεν [MASK] λόγος να περιμένουμε τρία χρόνια απλώς και μόνο για να υποβάλει προτάσεις η Επιτροπή .	υπάρχει
[MASK] επείγουσα ανάγκη να αναληφθεί δράση σ τον τομέα αυτό .	Υπάρχει
Τα προβλήματα τα [MASK] μάλλον εσείς σ τη δική σας , αλλά σκοπεύουμε να σας βοηθήσουμε .	έχετε
Πρέπει να [MASK] κανόνες που θα προστατεύουν τους πολίτες και τους καταναλωτές .	υπάρχουν
Αλλος ένας [MASK] για τον οποίον ο δάσκαλος θα κατσάδιαζε το Συμβούλιο είναι το ευρωπαϊκό δίπλωμα ευρεσιτεχνίας .	τομέας
[MASK] είναι το μήνυμα που στέλνουμε σ τις υπό ένταξη χώρες , εάν αδυνατούμε να υλοποιήσουμε εμείς οι ίδιοι τις δύσκολες μεταρρυθμίσεις που απαιτούμε από αυτές ;	Ποιο
Κύριε Πρόεδρε , [MASK] και εγώ , όπως οι συνάδελφοι μου , να σας συγχαρώ για την επανεκλογή σας ως Αντιπροέδρου .	θέλω
Δεν [MASK] νόημα σ το να πούμε ότι πρέπει να χρησιμοποιούμε το δημόσιο χρήμα απλώς και μόνο για να υποστηρίζουμε ένα αποτυχημένο ή απηρχαιωμένο σύστημα .	υπάρχει
[MASK] μια χρυσή τομή και μια ισορροπία μεταξύ των δύο , η οποία πρέπει να διατηρηθεί .	Υπάρχει
Με τον τρόπο αυτό [MASK] εύκολα οι υπηρεσίες επιθεωρήσεων σ το σύνολο της ΕΕ να διαπιστώνουν εάν ο ενλόγω οδηγός έχει προσληφθεί σωστά , δηλαδή σύμφωνα με τους ισχύοντες εθνικούς κανόνες που αφορούν την κοινωνική νομοθεσία .	μπορούν
Την στιγμή αυτήν είναι [MASK] η πραγματοποίηση ελέγχων σ το εξωτερικό μίας χώρας , εξαιτίας των διαφορετικών διατάξεων και εγγράφων που ισχύουν .	δύσκολη
Ως γνωστόν [MASK] και διμερείς και διεθνείς άδειες , καθώς και άδειες της CEMT ( Επιτροπής Απασχόλησης και Αγοράς Εργασίας ) , με τις οποίες μπορούν να εργαστούν νομίμως εντός της Ένωσης με συγκεκριμένο τρόπο οδηγοί από τρίτες χώρες .	υπάρχουν
Επ' αυτού δεν [MASK] οι απόψεις του Συμβουλίου και του Κοινοβουλίου .	διίστανται
Κυρία Πρόεδρε , πέρυσι σ τις 13_Δεκεμβρίου , [MASK] μια άγρια και φρικιαστική επίθεση εναντίον του κοινοβουλίου της Ινδικής Ένωσης σ το Δελχί , το οποίο είναι το πλέον απτό σύμβολο της δημοκρατίας και του κοσμικού εθνικού χαρακτήρα αυτής της χώρας .	εκδηλώθηκε
[MASK] βάσιμες ενδείξεις ότι σ την υπόθεση της απαγωγής του δημοσιογράφου της Wall Street Journal , Daniel Pearl , μπορεί να εμπλέκονται πρώην μέλη των πακιστανικών δυνάμεων ασφαλείας , υποστηρικτές των Ταλιμπάν .	Υπάρχουν
[MASK] επίσης αυτή τη στιγμή κάποια στοιχεία από μηνύματα ηλεκτρονικού ταχυδρομείου ότι ο ιθύνων νους που κατηύθυνε τον Richard Reid , ο οποίος έκρυβε εκρηκτικά σ τα παπούτσια του και προέρχεται , δυστυχώς , από τη χώρα μου , μπορεί να έδρασε με βάση το Πακιστάν .	Υπάρχουν
Θα [MASK] , λοιπόν , η Δύση το ίδιο λάθος ;	επαναλάβει
[MASK] είναι το γεγονός ότι όλο το μήνα Μάρτιο καταγράφονται κατά μέσο όρο 80 σίφωνες .	Χαρακτηριστικό
Για το ζήτημα αυτό έχει [MASK] και μία νομική εξέταση και ο Γενικός Εισαγγελέας αποφάνθηκε με σαφήνεια ότι είναι σωστή η δική μου άποψη , και άποψη της Επιτροπής Περιβάλλοντος , και όχι αυτή της Επιτροπής .	ξεκινήσει
Σε ελεύθερη [MASK] η ελευθερία του τύπου σ την Ελλάδα σύμφωνα με την ετήσια έκθεση του διεθνούς οργανισμού " Δημοσιογράφοι Χωρίς Σύνορα " .	πτώση
Νέα υποχώρηση της ελευθερίας του τύπου [MASK] σ την Ελλάδα η οργάνωση " Δημοσιογράφοι Χωρίς Σύνορα " , της οποίας η ετήσια έκθεση αποτελεί βαρόμετρο για την κατάσταση της ελευθερίας του τύπου σε ολόκληρο τον κόσμο .	διαπιστώνει
Ένας από αυτούς είναι ο αριθμός των βίαιων επιθέσεων εναντίον δημοσιογράφων , για τις οποίες ευθύνονται κυρίως οπαδοί της νεοναζιστικής οργάνωσης που εκπροσωπείται σ την ελληνική Βουλή και ένας άλλος λόγος είναι το κλείσιμο της ελληνικής δημόσιας τηλεόρασης και ο τρόπος με τον οποίο έγινε αυτό " , [MASK] η κ. Χολγκάντ .	επεσήμανε
Κύριε Πρόεδρε , θα [MASK] και εγώ να σας συγχαρώ για την εκλογή σας ως πρώτου Αντιπροέδρου .	ήθελα
Για να απαντήσω σ τον κ. Rapkay και σ τον κ. Hughes , [MASK] των οδηγιών περί δημοσίων συμβάσεων είναι ο συντονισμός των διαδικασιών για την ανάθεση μίας σύμβασης και όχι ο καθορισμός των υποχρεώσεων - κοινωνικών ή άλλων - με τις οποίες πρέπει να συμμορφώνονται οι ιδιώτες ανάδοχοι αφ' ης στιγμής ανατεθεί η σύμβαση .	σκοπός
Δεύτερος [MASK] ο πρώην Πρόεδρος της Βουλής , Νιούτ Γκίνγκριτζ , και ο προεδρικός υποψήφιος με τις περισσότερες εκλεκτορικές ψήφους μέχρι στιγμής , ο Μιτ Ρόμνεϊ , ήρθε τρίτος .	κατέληξε
[MASK] η ώρα οι συντηρητικοί να συσπειρωθούν για να μπορέσουν να αντιμετωπίσουν αποτελεσματικά τον Μπαράκ Ομπάμα σ τις εκλογές του Νοεμβρίου .	Ήρθε
[MASK] ο προκαθήμενος της Κοπτικής Εκκλησίας Σενούντα Γ'	Πέθανε
[MASK] ο προκαθήμενος της Κοπτικής Εκκλησίας Σενούντα Γ' , όπως μετέδωσαν αιγυπτιακά ειδησεογραφικά πρακτορεία , σε ηλικία 88 ετών .	Πέθανε
Σ την Αίγυπτο [MASK] περίπου 10 εκατομμύρια Κόπτες , οι οποίοι τα τελευταία χρόνια δέχονται αρκετές διώξεις εις βάρος τους από τον μουσουλμανικό πληθυσμό της χώρας .	ζουν
Σε 31 κράτη - πρόκειται για τα 15 κράτη μέλη , τις υποψήφιες προς ένταξη χώρες και τα μέλη του ευρωπαϊκού οικονομικού χώρου - μόνο σ το πλαίσιο των πανεπιστημιακών ανταλλαγών του ERASMUS [MASK] 21000 πανεπιστήμια , 40000 υφηγητές και περισσότεροι από 460000 φοιτητές .	συμμετείχαν
Σε αυτό το πλαίσιο , ήταν [MASK] η αύξηση του πολυετούς προϋπολογισμού από 850 εκατομμύρια ευρώ που ήταν αρχικά σε 933 εκατομμύρια ευρώ , την οποία επέτυχε το Ευρωπαϊκό Κοινοβούλιο με πολλές ολονύκτιες συζητήσεις .	σωστή
[MASK] φυσικά και σημεία που επιδέχονται κριτική .	Υπάρχουν
Ταυτόχρονα , όμως , είναι [MASK] και εύλογη η σύνδεσή του με τα προγράμματα JEUNESSE και LEONARDO .	δυνατή
Ωστόσο , είναι [MASK] το γεγονός ότι η αργοπορημένη σύναψη νέων συμβάσεων καθυστέρησε τις πληρωμές , ιδίως ως προς τη δράση COMENIUS .	λυπηρό
Για να τελειώνω , δεν [MASK] μία μοναδική και εύκολη απάντηση σ την ερώτηση πώς θα βελτιωθούν οι σχέσεις της Ένωσης με τον Νότιο Καύκασο .	υπάρχει
Δεν [MASK] να υπάρχουν ειδικά δικαιώματα για συγκεκριμένες απόψεις .	μπορούν
Η [MASK] ήταν και η φιλοσοφία μας ως προς τους μαθησιακούς στόχους .	ίδια
Διότι ακόμη και εντός των 15 κρατών μελών [MASK] υπερβολές ως προς αυτά .	γίνονται
Εδώ [MASK] μια ουσιαστική διαφορά σε σύγκριση με το παρελθόν , η οποία οφείλεται σε μεγάλο βαθμό σ την επιμονή του εισηγητή .	υπήρξε
Ωστόσο , [MASK] οι απόψεις μας σχετικά με τον τρόπο που αυτό κατέστη δυνατόν .	διίστανται
Τη σφραγίδα του εισηγητή δεν [MASK] μόνο η διαδικασία χορήγησης απαλλαγής και οι διάφορες εκθέσεις , αλλά και τα συνακόλουθα μέτρα που λήφθηκαν κατά τη διάρκεια της εν λόγω διαδικασίας .	φέρει
Κατά τη διάρκεια της διαδικασίας χορήγησης απαλλαγής [MASK] έντονες συζητήσεις για το ζήτημα αυτό , επειδή σε μια περίπτωση του 1994 το Κοινοβούλιο είχε εκτιμήσει ότι δεν ήταν διαφανής η απόφαση που είχαν λάβει οι υπηρεσίες της Επιτροπής .	υπήρξαν
[MASK] είναι η ρύθμιση που συμφωνήθηκε σε αντιστοιχία με την πρόταση ψηφίσματος .	Αυτή
Ποτέ δεν [MASK] παράπονα ότι η Επιτροπή επιχείρησε κατ' οιονδήποτε τρόπο να επηρεάσει αποτελέσματα ελέγχων της OLAF , και θέλω να το τονίσω αυτό .	ακούστηκαν
Με [MASK] ιδιαίτερα η χθεσινή απόφαση του Ευρωπαϊκού Δικαστηρίου .	χαροποίησε
Τις καταθέσεις , σ τις οποίες δεν έχει γίνει καμία κίνηση του λογαριασμού για 20 χρόνια έχει [MASK] σ το στόχαστρο το Υπουργείο Οικονομικών , καθώς μάλιστα σύμφωνα με εκτιμήσεις τραπεζικών στελεχών φθάνουν το ποσό των 3 δισεκατομμυρίων ευρώ .	βάλει
Σωστά [MASK] το σημείο αυτό η Επιτροπή , όμως δεν θα πρέπει να ελέγχεται μόνο εάν οι μεταφορείς αναγκάζουν τους οδηγούς να οδηγούν για υπερβολικά μεγάλα διαστήματα και με υπερβολικές ταχύτητες , διότι συχνά αναγκάζονται να φτάνουν σ τον προορισμό τους σε μία συγκεκριμένη χρονική στιγμή .	ελέγχει
Σ το ένα κράτος [MASK] κανείς να οδηγεί με 90 χιλιόμετρα την ώρα , σ το άλλο με 100 χιλιόμετρα την ώρα , ενώ σ το επόμενο κράτος μέλος μόλις με 80 χιλιόμετρα την ώρα .	μπορεί
Είναι [MASK] ο τρόπος με τον οποίο πραγματοποιούνται οι μεταφορές σ την Ευρώπη .	παράλογος
Εκτός από τους ελέγχους , [MASK] και το πρόβλημα των κυρώσεων .	υπάρχει
[MASK] καθήκοντα ο νέος Υπουργός Εξωτερικών των ΗΠΑ .	Ανέλαβε
[MASK] ο Τζων Ντέμιαντσουκ	Νεκρός
[MASK] χθες ο Τζων Ντέμιαντσουκ , γνωστός ως « Ιβάν ο Τρομερός » , πρώην δεσμοφύλακας σε ναζιστικά στρατόπεδα συγκέντρωσης .	Απεβίωσε
Έτσι αμέσως μετά τη Συνθήκη του Βερολίνου και τη προσάρτηση της Θεσσαλίας και τμήματος της Ηπείρου από την Ελλάδα [MASK] όλοι οι βαλκανικοί λαοί να ισχυρίζονται ότι οι Μακεδόνες ήταν αδέλφια τους που χάθηκαν σ το διάβα των αιώνων .	άρχισαν
Έτσι σ το χώρο της Μακεδονίας , [MASK] ένας έντονος αντάρτικος αγώνας μεταξύ των τεσσάρων εθνοτήτων που αποτελούσαν τον πληθυσμό της , των Ελλήνων , των Σλάβων , των Βούλγαρων και των Τούρκων .	άρχισε
Το 1908 όμως [MASK] το κίνημα των Νεότουρκων και η Μακεδονία ενσωματώθηκε σ την Οθωμανική Αυτοκρατορία ξανά .	ξέσπασε
[MASK] οι Βαλκανικοί Πόλεμοι το 1912_-_1913 , που δημιούργησαν τα σημερινά κράτη της Βαλκανικής χερσονήσου .	Ακολούθησαν
Σε αυτή την κίνηση [MASK] το Κομμουνιστικό Κόμμα Βουλγαρίας , με τα αντίστοιχα της Ελλάδας και της Γιουγκοσλαβίας να ακολουθούν , έχοντας να αντιμετωπίσουν εσωκομματικές αντιπαραθέσεις .	πρωτοστατούσε
[MASK] μια μακρά περίοδος έντασης μεταξύ Γιουγκοσλαβίας και Βουλγαρίας , με αμοιβαίες επιρρίψεις ευθυνών για προσπάθεια προσέγγισης της Γιουγκοσλαβικής Μακεδονίας , ενώ ταυτόχρονα οι αρχές του κράτους των Σκοπίων είχαν αρχίσει μια συντονισμένη εκστρατεία για τη διάδοση των θέσεών τους , που είχαν να κάνουν με την ταύτισή τους με τους Αρχαίους Μακεδόνες και την αλύτρωτη μακεδονική εθνότητα που ζει σ την Ελληνική Μακεδονία .	Ακολούθησε
[MASK] ήταν η αντίδραση των Αμερικανικών χρηματαγορών σ την υπερψήφιση του ρεπουμπλικανικού σχεδίου .	Θετική
Ακριβώς πίσω από την παραλία [MASK] η λίμνη Στροφυλιά , ένας σπάνιος υδροβιότοπος , ο οποίος αποτελεί μία προστατευόμενη περιοχή από το Δήμο Σκιάθου σ το πλαίσιο Ευρωπαϊκών Προγραμμάτων .	βρίσκεται
Σ τη λίμνη [MASK] καταφύγιο πολλά αποδημητικά πουλιά , όπως κύκνοι , τσικνιάδες , πάπιες και άλλα απειλούμενα είδη .	βρίσκουν
Σ τις Κουκουναριές [MASK] πλήθος ξενοδοχείων , ξενώνων , κάμπινγκ όπως και πολλές ταβέρνες , εστιατόρια , μπαρ , ουζερί και καφετέριες Όλες οι εγκαταστάσεις είναι από ξύλο .	βρίσκονται
Δυτικά από τις Κουκουναριές [MASK] οι παραλίες Μικρή και Μεγάλη Μπανάνα , Κρασά , Ασέληνο , Αγία Ελένη και Μανδράκι .	βρίσκονται
Σ το πρόγραμμα [MASK] 30 χώρες , συγκεκριμένα εκτός από τα κράτη μέλη της Ευρωπαϊκής Ένωσης , η Ισλανδία , το Λίχτενσταιν , η Νορβηγία , καθώς επίσης και οι υποψήφιες για ένταξη χώρες εκτός από την Τουρκία και την Μάλτα .	συμμετέχουν
Έτσι [MASK] να συμμετάσχουν 103.784 άτομα , πράγμα που αντιστοιχεί σε ποσοστό διάθεσης 98,5% , ένα εξαιρετικό ποσοστό αν αναλογιστεί κανείς ότι το πρόγραμμα άργησε να ξεκινήσει .	μπόρεσαν
Κατά κανόνα , για τα κεντρικά σχέδια [MASK] τέσσερις έως πέντε μήνες από την υποβολή της αίτησης μέχρι την έγκριση των κονδυλίων .	περνούσαν
Σ την αρχή [MASK] , επίσης , προβλήματα σ την κατανομή των πόρων του προγράμματος σ τις εθνικές υπηρεσίες .	υπήρξαν
[MASK] ότι η Επιτροπή θα μας δώσει ακριβέστερα στοιχεία και ότι θα προσέξει να επιδιωχθεί ισότιμη συμμετοχή των δύο φύλων , με κύριο στόχο να μην υπολείπονται σε αναλογία οι νεαρές γυναίκες και σ τα σχέδια των μη ευνοημένων νέων .	Ευελπιστώ
Εδώ πρέπει να [MASK] μεγαλύτερες προσπάθειες .	γίνουν
Μαζί με τον συνταγματάρχη [MASK] και ο γιος του , Μουατασίμ .	πέθανε
« Οι δύο άντρες , αν και τραυματίες , παρέμεναν ζωντανοί όταν πιάστηκαν αιχμάλωτοι απ' τους εξεγερμένους , αλλά αργότερα πέθαναν υπό αδιευκρίνιστες συνθήκες » , [MASK] το Γαλλικό Πρακτορείο .	αναφέρει
Ρεκόρ θνησιμότητας λόγω γρίπης [MASK] φέτος η Ελλάδα , καθώς τα 61 θύματα της νόσου είναι ήδη περισσότερα από το προηγούμενο έτος και πλησιάζουν επικίνδυνα τον αριθμό των νεκρών της περιόδου του 2011 - 2012 .	διεκδικεί
Για " εγκληματική έλλειψη εμβολιαστικής πολιτικής " σ την χώρα [MASK] λόγο ο Ιατρικός Σύλλογος Αθηνών σε ανακοίνωση που εξέδωσε .	κάνει
" Εκτεθειμένοι [MASK] φέτος πολλοί ασθενείς με χρόνιες παθήσεις και άτομα άλλων ευπαθών ομάδων του πληθυσμού , που δεν " πρόλαβαν " να εμβολιαστούν για τη φετινή εποχική γρίπη " .	έμειναν
Αντίσταση άξια λόγου [MASK] η ΕΛΔΥΚ και ορισμένα σώματα Κυπρίων Εθνοφρουρών , πολλοί από τους οποίους σκοτώθηκαν , αιχμαλωτίστηκαν ή χάθηκαν τα ίχνη τους .	πρόβαλε
Σ το μεταξύ σ την Ελλάδα [MASK] γενική επιστράτευση και κινητοποίηση στρατού , αλλά το ελληνικό καθεστώς , η Χούντα των Συνταγματαρχών , δεν προχώρησε παραπέρα και δεν αντέδρασε στρατιωτικά .	έγινε
Πρόεδρος [MASK] ο Γλαύκος Κληρίδης .	ανάλαβε
Σ τις 25_Ιουλίου_1974 [MASK] σ την Γενεύη οι ειρηνευτικές συνομιλίες για την Κύπρο , μεταξύ των Υπουργών Εξωτερικών των τριών εγγυητριών χωρών της Κυπριακής Ανεξαρτησίας ( Μαύρος , Γκιουνές , Κάλαχαν ) .	άρχισαν
[MASK] όμως και κάτι άλλο που προσπαθήσαμε και σ το παρελθόν να επιλύσουμε και πρέπει να το προσπαθήσουμε ξανά : να καταστήσουμε την ολομέλεια το επίκεντρο των τετραήμερων εργασιών μας σ το Στρασβούργο .	Υπάρχει
[MASK] αρκετός χρόνος σε άλλες ώρες για συναντήσεις με επιτροπές και αντιπροσωπείες , εκπροσώπους ομάδων πίεσης , κλπ. , όταν όμως είμαστε σ το Στρασβούργο , το επίκεντρο των δραστηριοτήτων μας πρέπει να είναι η ολομέλεια .	Υπάρχει
[MASK] είναι ένας από τους λόγους για τους οποίους αποφασίσαμε να θεσπίσουμε ειδικούς τομεακούς κανόνες , αντί να αναδιπλωθούμε σ το γενικό πλαίσιο των κανόνων για τον οριζόντιο περιορισμό .	Αυτός
[MASK] μια εισροή επιπλέον ανταγωνισμού .	Υπάρχει
Σε μειονεκτική [MASK] οι Τάταροι της Κριμαίας αν η Ρωσία επικρατήσει σ την περιοχή .	θέση
" Όλοι εδώ είναι τρομαγμένοι γιατί κανείς δεν ξέρει τι πρόκειται να συμβεί " , [MASK] ο Γιούντορ , κάτοικος του Μπαχτσισαράι .	λέει
Σ την Παναγία της Άμμου [MASK] η Παναγία η Μοναχή , μια σπάνια απεικόνιση της Παναγίας χωρίς το Θείο Βρέφος , η Παναγία η Κόγχη πιθανολογείται πως κτίστηκε σ τη θέση του ιερού της Εκβατήριας Αρτέμιδος ενώ ο Άγιος Γεώργιος ο Αφέντης κτίστηκε το 17ο αιώνα και έχει πολλές σπάνιες και αξιόλογες εικόνες .	βρίσκεται
Σε κοντινή απόσταση από τον Αρτεμώνα [MASK] η Απολλωνία και τα χωριά Άγιος Λουκάς και Άνω Πετάλι .	βρίσκεται
Όταν πουλάμε απευθείας σ τους καταναλωτές , όπως έγινε φέτος , έχουμε τη ρευστότητα για να αγοράσουμε τα εφόδια μας και να κάνουμε σωστά τη δουλειά μας » , [MASK] ο Σάββας Συμεωνίδης , παραγωγός πατάτας από το Νευροκόπι .	σημειώνει
Σ τα ανατολικά της πόλης της Κέρκυρας [MASK] το Παλαιό Φρούριο , χτισμένο τα μέσα του 16ου αιώνα , εντός του οποίου μπορεί κάποιος να δει το ναό του Αγίου Γεωργίου - μοναδική παγκοσμίως ορθόδοξη εκκλησία δωρικού ρυθμού - και τους παλιούς αγγλικούς στρατώνες .	βρίσκεται
Σ τα τείχη του Νέου Φρουρίου , σ τα δυτικά , [MASK] αποτυπωμένο το έμβλημα της Γαληνότατης Δημοκρατίας της Βενετίας , το λιοντάρι του Αγίου Μάρκου .	υπάρχει
[MASK] είναι και το αρχαιολογικό μουσείο Κέρκυρας , σ το οποίο φιλοξενούνται ευρήματα από ανασκαφές σ την Κέρκυρα και τη Θεσπρωτία και το σπίτι του Διονυσίου Σολωμού , το οποίο λειτουργεί ως μουσείο .	Σημαντικό
Τέλος σ το Ανάκτορο Αγίων Μιχαήλ και Γεωργίου που χρησίμευε ως έδρα του Μοναστηριακού Τάγματος των Αγίου Γεωργίου και Μιχαήλ [MASK] αξιόλογα δείγματα ασιατικής τέχνης .	βρίσκονται
« Ο Κρίστιαν Βουλφ ήταν πολύ συνεργάσιμος » , [MASK] εκπρόσωπος της Εισαγγελίας .	ανάφερε
Ακούγοντας τα λόγια σας [MASK] κανείς ότι δεν θεωρείτε την αποστολή σας ως Προέδρου απλή εκπροσώπηση του Κοινοβουλίου προς τα έξω , παρά αντίθετα ενδιαφέρεστε θερμά για την πολιτική , για όλα όσα μπορούμε να κάνουμε εδώ σ το Ευρωπαϊκό Κοινοβούλιο .	ένιωθε
Επίσης , [MASK] διάφορα σχετικά με τη συντακτική συνέλευση .	ακούγονται
[MASK] είναι άλλωστε η νέα μέθοδος , εσείς το είπατε .	Αυτή
Κατά τους ειδικούς , « αίτια αυτών των τραγικών συμβάντων [MASK] το αλκοόλ , η βία εντός της οικογένειας και οι κακές σχέσεις νέων - γονέων .	αποτελούν
Σ τις μεγάλες πόλεις κύρια [MASK] είναι η απομόνωση ενώ σ τις μικρότερες είναι οι αυστηροί κανόνες » .	αιτία
[MASK] τα νέα για τη γρίπη των πτηνών	Ενθαρρυντικά
Σ την παρασκευή ενός εμβολίου για ανθρώπους κατά της γρίπης των πτηνών θα [MASK] το Βιετνάμ , όπου 33 άνθρωποι έχουν χάσει τη ζωή τους εξαιτίας της θανατηφόρας αρρώστιας .	προχωρήσει
" Θα καταβάλουμε κάθε προσπάθεια για να ολοκληρώσουμε την έρευνα το συντομότερο δυνατόν γιατί το Βιετνάμ έχει πραγματικά ανάγκη το εμβόλιο αυτό " , [MASK] η Νγκουγέν Τι Χονγκ Χανχ αναπληρώτρια διευθύντρια του Εθνικού Ινστιτούτου Επιδημιολογίας .	τόνισε
" Μετά τις δοκιμές σε πιθήκους θα ζητήσουμε από το υπουργείο Υγείας της χώρας να μας επιτρέψει να δοκιμάσουμε το εμβόλιο σε εκατό ανθρώπους " , [MASK] η κα. Χανχ .	πρόσθεσε
Ανάλογα πειράματα [MASK] και άλλες χώρες .	πραγματοποιούν
Σ το Βιετνάμ , έχουν [MASK] περισσότερα από 1,5 εκατομμύρια πουλερικά εξαιτίας της ασθένειας , ενώ κρούσματα έχουν εμφανιστεί σ τις 35 από τις 64 πόλεις και επαρχίες .	πεθάνει
Σ τις 3_Σεπτεμβρίου_1895 [MASK] επανάσταση , που δεν βρήκε σύμφωνο το Βενιζέλο , ο οποίος θεωρούσε ότι οι Κρητικοί δεν έπρεπε να ενεργούν αυτοβούλως αλλά σε συνεννόηση με την ελληνική κυβέρνηση σ την Αθήνα .	ξέσπασε
[MASK] ο ίδιος νύχτα σ το Ακρωτήρι όπου ύψωσε την ελληνική σημαία .	Πέρασε
Σ τους ναυάρχους την [MASK] ο επικεφαλής της ελληνικής ναυτικής μοίρας Ράινεκ .	μετέφερε
Σε πολλές ευρωπαϊκές πρωτεύουσες [MASK] διαδηλώσεις συμπαράστασης σ τους επαναστάτες ενώ το προεδρείο της Βουλής των Ελλήνων σ την Αθήνα έπαιρνε πλήθος τηλεγραφήματα από διασημότητες της εποχής που συνιστούσαν σ την ελληνική κυβέρνηση να τηρήσει πιο αποφασιστική στάση υπέρ των Κρητικών .	έγιναν
Την κυβέρνηση Δηλιγιάννη [MASK] η κυβέρνηση Ράλλη κι αυτήν η κυβέρνηση Αλέξανδρου Ζαΐμη , που υπέγραψε σ την Κωνσταντινούπολη συνθήκη ειρήνης με την Τουρκία .	διαδέχθηκε
Ακόμα μια νίκη [MASK] ο Μιτ Ρόμνεϊ	πέτυχε
Αντιμέτωποι με ακραία καιρικά φαινόμενα [MASK] οι κάτοικοι των νοτίων Πολιτειών της Αμερικής .	βρίσκονται
[MASK] ένας εκλεγμένος Πρόεδρος αυτού του παλαιστινιακού κράτους και δεν μπορούμε να τον αγνοήσουμε ούτε εμείς ούτε ο κ. Sharon .	Υπάρχει
Σ τις 16_Αυγούστου_1916 [MASK] συλλαλητήριο σ την Αθήνα ( κίνημα της Εθνικής Αμύνης ) , όπου με την υποστήριξη του συμμαχικού στρατού , που είχε αποβιβαστεί σ την πρωτεύουσα της Μακεδονίας , ο Βενιζέλος ανακοίνωσε σ το λαό την πλήρη διαφωνία του με τους χειρισμούς του Στέμματος .	έγινε
[MASK] και τα άλλα νησιά του Αιγαίου .	Προσχώρησαν
Σ την Αθήνα , [MASK] η Αντάντ και υποχρέωσε την κυβέρνηση Σκουλούδη να παραιτηθεί .	επενέβη
Την κυβέρνηση αυτή [MASK] νέα υπό τον Αλέξανδρο Ζαϊμη .	διαδέχθηκε
Όταν η Γερμανία υπέγραψε ανακωχή , [MASK] σ το Παρίσι η συνδιάσκεψη της ειρήνης , όπου ο Βενιζέλος παρέστη ως αντιπρόσωπος της Ελλάδας και πρόβαλε τις αξιώσεις της χώρας μας , οι οποίες έγιναν σ το σύνολό τους δεκτές με τις συνθήκες του Νεϊγύ ( 27_Νοεμβρίου_1919 ) και των Σεβρών ( 10_Αυγούστου_1920 ) .	συνήλθε
Ενώ επρόκειτο να γυρίσει σ την Ελλάδα , [MASK] δολοφονική απόπειρα εναντίον του σ τον σιδηροδρομικό σταθμό της Λυόν , σ το Παρίσι από δύο απότακτους Έλληνες αξιωματικούς .	έγινε
[MASK] βουλευτικές εκλογές την 1_Νοεμβρίου_1920 .	Έγιναν
Την μεθεπομένη [MASK] κυβέρνηση ο Δημήτριος Ράλλης , παραιτήθηκε ο Κουντουριώτης κι έγινε αντιβασίλισσα η βασιλομήτωρ Όλγα μέχρι να γίνει δημοψήφισμα , το οποίο θα επανέφερε τον εξόριστο Κωνσταντίνο .	σχημάτισε
Εξαιτίας του δυστυχήματος σε τούνελ της Ελβετίας , σ το καντόνι του Wallis , τη ζωή τους [MASK] οι δύο οδηγοί , 22 παιδιά και τέσσερις συνοδοί , ενώ επίσης τραυματίστηκαν άλλα 24 άτομα .	έχασαν
Την έκδοση του Αμπντάλα αλ Σενούσι [MASK] η Λιβύη	επιθυμεί
[MASK] ο Σεργκέι Ουνταλτσόφ	Ελεύθερος
Η Αστυνομία απέκλεισε την πόλη με σκοπό να βρεί τους κρατούμενους και να τους ξαναβάλει σ τη φυλακή » , [MASK] εκπρόσωπος των τοπικών αρχών .	δήλωσε
Καθεστώς ημιαυτονομίας [MASK] η Μισουράτα	επιθυμεί
Παρόμοιο καθεστώς [MASK] και οι πόλεις σ τα ανατολικά της Λιβύης , οι οποίες είναι πλούσιες σε κοιτάσματα πετρελαίου .	επιδιώκουν
[MASK] μια κατηγορία εναντίον του κ. Pasqua , αλλά όχι εναντίον του κ. Marchiani , για παράνομη χρηματοδότηση προεκλογικής εκστρατείας μέσω αποδοχής δωρεών και χρηματοδότησης της εκστρατείας για τις ευρωπαϊκές εκλογές , κατά παράβαση των διατάξεων του άρθρου L 52.8 του Εκλογικού Κώδικα .	Υπάρχει
[MASK] είναι η κατάσταση επί της οποίας πρέπει να αποφασίσουμε .	Αυτή
Σύμφωνα με το άρθρο 10 του Πρωτοκόλλου του 1965 , δεν [MASK] σχετική ασυλία για βουλευτή της Γαλλικής Εθνοσυνέλευσης ή , κατά συνέπεια , για γάλλο βουλευτή του Ευρωπαϊκού Κοινοβουλίου σε περίπτωση δίωξης για κατηγορίες αυτού του είδους .	υφίσταται
[MASK] μια άλλη πλευρά της υπόθεσης , η οποία , δυστυχώς , γεννά την υποψία ότι η πρόνοια σχετικά με τις προϋποθέσεις ελεύθερης διεξαγωγής του κοινοβουλευτικού έργου δεν απασχόλησε επαρκώς την εισαγγελική αρχή :	Υπάρχει
Εκεί [MASK] η συζήτηση , κυρίως γιατί εγώ με δυσκολία κρατάω ανοιχτά τα μάτια μου και δεν έχω δυνάμεις να λειτουργήσω σαν ηρεμιστικό για τα άγχη και τις ανασφάλειες της Αδριανής .	σταματάει
Και τι είχε [MASK] ο Σωτηρόπουλος , για να φτάσουν σ το σημείο να τον δολοφονήσουν και να πάρουν τον υπολογιστή του ;	ανακαλύψει
Τελευταία [MASK] η ξερακιανή , με ύφος αγανακτισμένο .	αποχωρεί
Από αυτό το σημείο [MASK] η σιωπή της βουλιμίας , γιατί πέφτουμε όλοι με τα μούτρα σ το φαγητό .	επικρατεί
Με [MASK] ένας σαρανταπεντάρης με αραιά μαλλιά .	υποδέχεται
Δεν [MASK] καμία αμφιβολία ότι αυτά τα περί φίλου που κάηκε σ τη φωτιά του πλοίου είναι ραπανάκια για το κουκούλωμα .	υπάρχει
Δε θα το [MASK] κανείς άλλος .	μάθει
« [MASK] άλλες λεπτομέρειες ; »	Υπάρχουν
« Θα σε [MASK] ο Ούλι » .	βοηθήσει
« Αλλού [MASK] η απορία » συμπληρώνει μετά .	βρίσκεται
Ο άλλος [MASK] είναι τα λεφτά .	σκώρος
Κανονικά δε [MASK] άλλες εξηγήσεις , αλλά ο Ζήσης βιάζεται να τα πει όλα .	χρειάζονται
« Πού [MASK] η Κατερίνα ; »	είναι
« Ακόμα και αν το κάναμε , πόσο αξιόπιστη θα [MASK] το δικαστήριο την αστυνομία του Ιράκ ; »	θεωρούσε
[MASK] το λιγότερο που μπορούμε να της προσφέρουμε .	Είναι
[MASK] η Αδριανή .	διαμαρτύρεται
με [MASK] ο Δερμιτζάκης .	ρωτάει
Δεν [MASK] όμως κάτι επιβαρυντικό .	προέκυψε
« Εντάξει » [MASK] ο Φελεκίδης συμβιβαστικά .	λέει
Δεν [MASK] ληστεία , αλλά κανονική εκτέλεση με παράπλευρο τρόπαιο τον υπολογιστή .	ήταν
[MASK] ήταν αυτός ;	Ποιος
« Όχι , έχουν [MASK] και οι δύο » .	πεθάνει
Τρελοί [MASK] και ο Πακιστανός με τον Αφγανό και οι δύο Γεωργιανοί να ομολογήσουν δολοφονίες που δε διέπραξαν ;	είναι
Δεν τον [MASK] οι δολοφόνοι , αλλά τα ναυάγια .	ενδιέφεραν
« Πού [MASK] ο Σωτηρόπουλος ; »	δούλευε
Δεν [MASK] αυτός που έκανε ερωτήσεις σ την press conference του υπουργού Ναυτιλίας ;	ήταν
Ναι , αν [MASK] κανείς έτσι αυτό που μου είπε .	δει
Με έχει [MASK] και εκείνος και μου κάνει νόημα με το χέρι του .	δει
« Κάπου σ το Κερατσίνι » μου [MASK] αόριστα ο Βλασόπουλος .	απαντάει
Μετά τους εναγκαλισμούς και τις διαχύσεις , [MASK] κι εμείς τη θέση μας σ το τραπέζι .	παίρνουμε
Με [MASK] δυο ένστολοι αστυνομικοί .	πλησιάζουν
« Καλά , πώς [MASK] αυτό ; »	έγινε
[MASK] ο Ζήσης , που ήρθε να μας πει τις ευχές του με το απαραίτητο πακέτο σ το χέρι .	Είναι
Τον Σωτηρόπουλο δεν τον [MASK] ο Ασιάτης Μαχμούντ .	σκότωσε
[MASK] και κάτι ακόμα που με προβληματίζει .	Υπάρχει
« [MASK] ένα ταξίδι ρουτίνα , για να τσεκάρουμε τα γραφεία μας σ την Ελλάδα » .	Ήταν
« Πού [MASK] το ταξί ; »	είναι
Του [MASK] εξίσου ο Άλιμος ή η μαρίνα της Βουλιαγμένης .	έκανε
[MASK] ο Σίμον .	ρωτάει
Και όπως κάθομαι βουβός , με το ποτήρι όρθιο , [MASK] από το μυαλό μου , σαν αστραπή η σκέψη , ότι έτσι ήταν όλος ο κοινός μου βίος με την Αδριανή : κάπου μεταξύ κατσάδας και συγκίνησης .	περνάει
« Τι [MASK] η παροιμία , κυρία Αδριανή ; »	λέει
Αν δεν ήταν ο Σωτηρόπουλος , που έχει τις ίδιες αμφιβολίες μ' εμένα , θα μου είχε [MASK] η ιδέα ότι πάσχω από μανία καταδιώξεως .	μπει
[MASK] μία και τέταρτο .	Είναι
« Μας το [MASK] ο μάρτυρας που σας φέραμε » .	ανέφερε
[MASK] η Κατερίνα με τον Φάνη και τα συμπεθέρια για το Χριστός Ανέστη .	Είναι
« [MASK] η γλώσσα της Αδριανής » .	Μάλλιασε
με [MASK] η Αδριανή , όταν μπαίνω σ το σπίτι .	ρωτάει
« Πρώτα [MASK] από δολιοφθορά δύο καράβια του Χαρδάκου και μετά δολοφονείται ο ίδιος » .	βουλιάζουν
[MASK] η Αδριανή .	απορεί
« Δεν [MASK] πια capital controls » του εξηγεί η Κατερίνα .	υπάρχουν
Με [MASK] η Αδριανή , μισοκοιμισμένη .	ρωτάει
« Δεν [MASK] ο πατέρας μου , γιατί δεν είχε εμπιστοσύνη σ τις κυβερνήσεις της Ελλάδας » .	ήθελε
Με [MASK] ο Γκίκας .	ρωτάει
« Το ίδιο [MASK] κι εμείς » .	πιστεύουμε
Από την άλλη , δεν [MASK] η παραμικρή σχέση ανάμεσα σ τη δολοφονία του Λαλόπουλου και σε εκείνη του Χαρδάκου .	υπάρχει
[MASK] ο Παπαδάκης .	Επιμένει
Έστω και αν βούλιαξαν με δολιοφθορά , τι θα [MASK] αυτοί που τα βούλιαξαν από το φόνο του Χαρδάκου ;	κέρδιζαν
Εκτός [MASK] η ακρόαση μετά ψιθύρων .	επικρατεί
Κι εδώ [MASK] δύο απαντήσεις , μία εύκολη και μία δύσκολη .	υπάρχουν
Πρώτος [MASK] ένας ευθυτενής εξηντάρης με άσπρα μαλλιά , σκούρο κοστούμι , διανθισμένο με γραβάτα και μαντίλι σ το τσεπάκι του σακακιού .	εμφανίζεται
« Εκεί [MASK] όλη η οικογένεια όταν ερχόταν σ την Αθήνα » .	έμενε
« Από την αστυνομία » [MASK] η Αννα , ενώ σκουπίζει τα μάτια της .	απαντάει
[MASK] η γυναίκα που είχαμε ανακρίνει σ το δρόμο , σ το Δήλεσι .	Είναι
[MASK] ωστόσο η πιθανότητα να μην πουλάει μόνο εξυπνάδα αλλά να ξέρει και λεπτομέρειες που εμείς αγνοούμε .	Υπάρχει
τον [MASK] ο Παπαδάκης .	ρωτάει
Σ το βάθος [MASK] μια πόρτα , που ανοίγει σε έναν προθάλαμο με γραφείο , δύο μεταλλικές καρέκλες και μια αρχειοθήκη με ερμάρια .	υπάρχει
« Τώρα [MASK] ένας συνταξιούχος δίχως φιλοδοξίες , συνεπώς δεν έχουμε πια και κόντρες » μου λέει γελώντας και σηκώνεται .	είμαι
[MASK] ο Βλασόπουλος τον Δερμιτζάκη .	σιγοντάρει
Μήπως τελικά [MASK] οι υποψίες του Σωτηρόπουλου , που από την αρχή έβλεπε να υπάρχει σχέση ανάμεσα σ τη δολοφονία του Χαρδάκου και σ την επιστροφή των ναυτιλιακών εταιρειών ;	ευσταθούν
Εκεί πάνω [MASK] το τηλέφωνο .	χτυπάει
« [MASK] στραβό το κλίμα , το 'φαγε και ο γάιδαρος » μου λέει .	Ήταν
Παλιά , αυτά τα κουρέλια τα [MASK] οι φτωχοί σ τις συνοικίες που έφαγα τη ζωή μου .	φορούσαν
[MASK] η πρώτη φορά που ο Γκίκας ανοίγει το στόμα του .	Είναι
Τώρα [MASK] τα δύσκολα και πρέπει να δω πώς θα του τα σερβίρω .	αρχίζουν
Από εκεί [MASK] δυο βήματα ως τον υπαρχηγό και άντε να τα μαζέψεις .	είναι
Ξαφνικά μου [MASK] η ιδέα και πετάγομαι από τη θέση μου .	κατεβαίνει
Η [MASK] που καταλαβαίνω είναι τα σπαγγέτι .	μόνη
« [MASK] χαμός » μου λέει ο Βλασόπουλος .	Έγινε
Δεν [MASK] περίπτωση να έχουμε γιορτή σ το σπίτι και να λείπει ο Ζήσης .	υπάρχει
Σε λίγο [MASK] από το τμήμα δύο τριαντάρηδες Ασιάτες με χειροπέδες .	βγαίνουν
Αυτή τη φορά [MASK] εμάς η μπάλα .	πήρε
Μπροστά σ την εκκλησία μάς [MASK] η Μάνια με τον Ούλι .	περιμένουν
« Πού [MASK] σ την Αθήνα ο Χαρδάκος ; »	έμενε
Η πρώτη μου [MASK] , όταν μπαίνω σ τα γραφεία της West Shipping , είναι εκείνη της κανονικότητας .	εντύπωση
[MASK] όμως αυτός ο γιατρός να πάει κάποτε για διακοπές σ την Ιρλανδία ή σε ένα οποιοδήποτε άλλο κράτος μέλος της ΕΕ , εφόσον η Ιρλανδία ζητήσει την παράδοσή του για φόνο ;	Μπορεί
Τώρα με το ευρωπαϊκό ένταλμα σύλληψης [MASK] η ανάγκη αυτή και διαθέτουμε ένα όπλο προκειμένου να εξασφαλίσουμε αυτή την προστασία των πολιτών μας σ το σύνολο της Ευρωπαϊκής Ένωσης .	υπάρχει
Εφόσον το Συμβούλιο ακολουθήσει τόσο αποφασιστική και δυναμική στάση υπέρ της εξασφάλισης των δικαιωμάτων των πολιτών όπως κάνει και για τη λήψη κατασταλτικών μέτρων , τότε δεν θα [MASK] το ευρωπαϊκό ένταλμα σύλληψης , και μάλιστα όχι τώρα που η Επιτροπή υπέβαλε μία πρώτη εκδοχή των ελαχίστων προδιαγραφών , δείχνοντας έτσι ότι αυτές είναι τόσο αναγκαίες όσο και δυνατές .	καθυστερήσει
Ούτε καν [MASK] αναφορά σε αυτές .	γίνεται
Έχοντας ως ορμητήριο την Ηγουμενίτσα [MASK] ο επισκέπτης να πραγματοποιήσει εκδρομές προς τα κοντινά παραλιακά χωριά Πλαταριά , Σύβοτα , Πέρδικα .	μπορεί
Παράλληλα τον 16ο αιώνα [MASK] η ανάπτυξή της , η οποία και συνεχίστηκε σε γρηγορότερους ρυθμούς μετά την απελευθέρωσή της , το 1913 .	ξεκινά
Επιπλέον εδώ [MASK] αρχαιολογικό μουσείο , το οποίο μεταξύ άλλων φιλοξενεί ευρήματα από τα προϊστορικά χρόνια και λαογραφικό μουσείο με όμορφες φορεσιές , κοσμήματα και εργόχειρα .	λειτουργούν
« Παγκόσμια [MASK] » η εκτόξευση πυραύλου από τη Βόρεια Κορέα	απειλή
« Η Βόρειος Κορέα αγνόησε τις διεθνείς υποχρεώσεις της , απέρριψε κατηγορηματικές εκκλήσεις για αυτοσυγκράτηση και απομονώθηκε περαιτέρω από την κοινότητα των υπόλοιπων εθνών » [MASK] ο Μπαράκ Ομπάμα .	δήλωσε
« Καλώ τη Β. Κορέα να τηρήσει τη δέσμευσή της για την εγκατάλειψη του συνόλου των προγραμμάτων πυρηνικών όπλων » [MASK] ο Ομπάμα και υπογράμμισε :	πρόσθεσε
Εξιτήριο από το νοσοκομείο της Νέας Υόρκης [MASK] η Χίλαρι Κλίντον .	πήρε
Πάντως , σ την ανακοίνωση δεν [MASK] λόγος για το αν η Χίλαρι Κλίντον θα επιστρέψει σ τη δουλειά της σ την Ουάσιγκτον .	γίνεται
Όμως , νέα τροπή σ τα ιατρικά δεδομένα [MASK] να δώσει ένα λογισμικό πρόγραμμα , που δημιούργησε ο Δρ Τσαρλς Τέιλορ , από το Πανεπιστήμιο του Στάνφορντ , με το οποίο χρησιμοποιεί εικόνες από τα αιμοφόρα αγγεία , από τη ροή της κυκλοφορίας του αίματος του καθενός , που σε συνδυασμό με την επιστημονική εμπειρία , μπορεί να προβλέψει κατά ένα μεγάλο ποσοστό την έκβαση της επέμβασης .	έρχεται
" Τελικά , πιστεύω , ότι θα γίνει μέρος της συνηθισμένης διαδικασίας και οι χειρούργοι θα συμβουλεύονται πρώτα τον υπολογιστή τους και μετά θα προχωρούν σ την επέμβαση " [MASK] ο Δρ. Τέιλορ .	καταλήγει
Είναι [MASK] το γεγονός ότι ενεργούμε όλο και περισσότερο διασυνοριακά .	θετικό
Πέρυσι το φθινόπωρο [MASK] πολλοί για την δυνατότητα εξάπλωσης της ΣΕΒ σ τα πρόβατα .	ανησυχούσαν
Σ την έρευνα η οποία θα έπρεπε να είχε πραγματοποιηθεί για τα πρόβατα δεν [MASK] εγκέφαλοι προβάτων , αλλά , από ό,τι φαίνεται , εγκέφαλοι βοειδών .	εξετάστηκαν
Για το λόγο αυτό θα πρέπει να [MASK] η λεγόμενη " απαγόρευση του κανιβαλισμού " , έτσι ώστε να απαγορεύεται η παροχή σε ζώα ζωοτροφών που προέρχονται από ζώα του ίδιου είδους .	επιβληθεί
[MASK] μεγάλη συζήτηση σχετικά με τη χρηματοδότηση σχεδίων αντί της στήριξης του προϋπολογισμού .	Γίνεται
[MASK] για αυτό είναι το Κοινοβούλιο .	Υπαίτιο
Την έκδοση του Φετουλάχ Γκιουλέν σ την Τουρκία θα [MASK] ο Ερντογάν από τις ΗΠΑ .	ζητήσει
[MASK] της Σίφνου είναι η Απολλωνία , ένα γραφικότατο χωριό , σ το κεντρικότερο σημείο του νησιού , που οφείλει το όνομά του σ το θεό Απόλλωνα .	Πρωτεύουσα
Ανάμεσα σ τα στενά δρομάκια , τα ασβεστωμένα σκαλιά , τα ολόλευκα σπίτια σε σχήμα κύβου και τις δεκάδες εκκλησίες , την προσοχή σας θα [MASK] οι διάσημοι φλάροι , τα ιδιαίτερα κεραμικά της Σίφνου που τοποθετούνταν σ τις καπνοδόχους των σπιτιών .	τραβήξουν
Δίπλα σ την Απολλωνία , ενωμένος πλέον μ' αυτήν , [MASK] ο Αρτεμώνας , ένα χωριό γεμάτο νεοκλασικά κτίρια , παλιά αρχοντικά και ανεμόμυλους .	βρίσκεται
Σ τον Πλατύ Γιαλό [MASK] μια από τις πιο ωραίες και πολυσύχναστες παραλίες του Αιγαίου , η οποία διαθέτει εξοπλισμό και για θαλάσσια σπορ , ενώ κοντά σ το χωριό υπάρχει και η Ιερά Μονή των Ταξιαρχών .	βρίσκεται
Σ το χώρο [MASK] μνημεία από ένα συνονθύλευμα πολιτισμών , ενώ η θέα προς το Αιγαίο είναι υπέροχη .	υπάρχουν
[MASK] από τις πιο γνωστές παραλίες του νησιού είναι ο Πλατύς Γιαλός , το Βαθύ , ο Φάρος , η Χερρόνησος και οι Καμάρες .	Μερικές
Σ την είσοδο της παλιάς Χώρας [MASK] τα παραδοσιακά πέτρινα αλώνια για τα σιτηρά .	βρίσκονται
Από τον Άγιο Κωνσταντίνο και το Βόλο [MASK] καθημερινή σύνδεση με την Αλόννησο και τα υπόλοιπα νησιά των Σποράδων , με οχηματαγωγό πλοίο ή ιπτάμενο δελφίνι .	υπάρχει
Σε προσωρινό μορατόριουμ [MASK] η Βόρεια Κορέα	συμφώνησε
Πλέον [MASK] 31 χιλιόμετρα προς Γρεβενά για να ολοκληρωθεί ολόκληρος ο άξονας της Εγνατίας .	απομένουν
Από τον Μάιο θα μπορεί ο καθένας να διατρέχει ολόκληρη την ΕΓΝΑΤΙΑ από την Ηγουμενίτσα μέχρι τους Κήπους του Έβρου » [MASK] ο κ. Σουφλιάς .	δήλωσε
Αποτέλεσμα της έκρηξης [MASK] ο θάνατος ενός καμικάζι και ενός φρουρού ασφαλείας , καθώς επίσης και ο τραυματισμός μιας γυναίκας , η οποία βρισκόταν εκεί για να λάβει θεώρηση εισόδου .	αποτελεί
Παράλληλα , το φυλάκιο έξω από την πρεσβεία , καθώς επίσης και το κτήριο της πρέσβειας , έχουν δεχτεί σοβαρές ζημιές " , [MASK] ο Αλααντίν Γιουκσέλ , Κυβερνήτης της Άγκυρας .	αναφέρει
Η αναχαίτιση του - πυραύλου φορέα δορυφόρου είναι μια απ' αυτές τις επιλογές » , [MASK] ο Υπουργός Αμύνης της Ιαπωνίας , Ναόκι Τανάκα .	δήλωσε
Την έντονη αντίδραση τους για την εκτόξευση πυραύλου από τη Βορεία Κορέα είχαν [MASK] οι ΗΠΑ , οι οποίες δήλωσαν ότι « η Βόρεια Κορέα θέλει να δοκιμάσει βαλλιστικό πύραυλο » .	εκφράσει
Την αντίδραση της [MASK] και η Ρωσία , η οποία κάλεσε τους Βορειοκορεάτες να « μην κάνουν βήματα που θα φέρουν συρράξεις σ τη χερσόνησο » .	εξέφρασε
Ήδη σήμερα [MASK] πολλοί γιατί δεν είχε κυκλοφορήσει το ευρώ πολύ νωρίτερα όπως το ζητούσαμε εμείς οι βουλευτές .	αναρωτιούνται
Ιδιαίτερα σημαντικό ρόλο [MASK] ο ζήλος που επιδείξαμε σ τον νομισματικό διάλογο με την Ευρωπαϊκή Κεντρική Τράπεζα .	έπαιξε
Μια φαρμακοβιομηχανία χρειάζεται 14 χρόνια για να αναπτύξει ένα νέο φάρμακο με κόστος 1 δισεκατομμύριο δολάρια κατά μέσο όρο , και το 99% των ερευνητικών προσπαθειών αποτυγχάνουν , [MASK] ο κ. Κόλλινς , προσθέτοντας :	επεσήμανε
[MASK] όλοι με τον Βαρόνο Lamfalussy και την επιτροπή σοφών ότι για την αποτελεσματική ρύθμιση των χρηματαγορών και τη δημιουργία μιας ενιαίας χρηματοπιστωτικής αγοράς απαιτείται να εκχωρήσουμε αρμοδιότητες σ την Επιτροπή και σε μια πιο ευέλικτη επίσημη επιτροπή .	Συμφωνούμε
[MASK] όμως ένα βασικό πρόβλημα .	Υπάρχει
Δεν [MASK] μόνο το κύμα των τουριστών που κλείνει ό,τι βρει για φέτος το καλοκαίρι .	είναι
« Πάντως , δεν [MASK] τίποτα ύποπτο σ' αυτές τις εταιρείες »	υπάρχει
Λίγο πιο πέρα [MASK] ο Ασιάτης Μαχμούντ και κοιτάζει το δρόμο .	στέκεται
Καθ' οδόν προς την κουζίνα [MASK] το κουδούνι , και η Αδριανή αλλάζει ρότα για ν' ανοίξει .	χτυπάει
« [MASK] είναι αυτό ; »	Τι
Με [MASK] ο Βλασόπουλος :	διακόπτει
Δεν τον [MASK] εμείς , αλλά οι Άγγλοι .	έχουμε
Το [MASK] σ την εποχή μας είναι εννιά σ τις δέκα φορές το χρήμα , και εδώ είναι που κολλάω .	κίνητρο
[MASK] επίσης η πρώτη φορά που λέει κάτι για να με καλύψει .	Είναι
Ξαφνικά [MASK] ένα βουητό από το διάδρομο .	ακούγεται
[MASK] η μέρα που κυκλοφορώ μεταξύ Αθήνας και Πειραιά σαν αστική συγκοινωνία .	Είναι
[MASK] και εδώ κύκλοι σ τις ίδιες μέρες , αλλά οι κύκλοι δεν έχουν εδώ αριθμό , αλλά ένα όνομα :	Υπάρχουν
« [MASK] , δεν είστε οι πρώτοι που ερωτεύεστε σε υπηρεσιακό περιβάλλον » τους λέω .	Ακούστε
Ξαφνικά μου [MASK] μια ιδέα που με αναστατώνει .	έρχεται
« Ο περιπτεράς » μου [MASK] ο Βλασόπουλος .	απαντάει
με [MASK] ειρωνικά η ξερακιανή .	ρωτάει
[MASK] και οι δυο τις λαμπάδες τους και μας χαμογελάνε .	Κρατάνε
Μας [MASK] μια ηλικιωμένη ασπρομάλλα .	ανοίγει
Μαζί τους [MASK] και η Μάνια με τον Ούλι .	είναι
Κατά τη γνώμη του [MASK] δουλειά της ασιατικής μαφίας , χωρίς να ξέρει ποια θα μπορούσαν να ήταν τα κίνητρα .	ήταν
« [MASK] συνάντησης είναι ο σταθμός Πελοποννήσου » .	Τόπος
[MASK] πενήντα χιλιάρικα .	Είναι
Και εδώ [MASK] το ερώτημα : τι κρύβεται πίσω από τα ναυάγια και τη δολοφονία του Χαρδάκου , που δεν πρέπει να αποκαλυφθεί ;	μπαίνει
[MASK] μια μέρα να πήρα το κινητό από έναν άλλο ταξιτζή για να τηλεφωνήσω και να με είδε ο περιπτεράς .	Μπορεί
[MASK] η δεύτερη φορά μέσα σε λίγες μέρες , που η Αδριανή φτιάχνει γεμιστά .	Είναι
[MASK] οι λεπτομερείς περιγραφές από τις διακοπές του Πάσχα , ώσπου φτάνουμε σ τον κατάλογο .	Ακολουθούν
[MASK] μια κλήση δυο μέρες πριν από τη δολοφονία του Χαρδάκου , και άλλες δύο τη μέρα μετά τη δολοφονία του .	Υπάρχει
Επειδή ήξερα τις αμφιβολίες του σ την υπόθεση Χαρδάκου , δε μου [MASK] καθόλου παράξενο αυτό που έλεγε .	φαίνεται
Σ τη συνέχεια [MASK] και χάθηκαν τα ίχνη του .	εξαφανίστηκε
Αυτά [MASK] οι γραφειοκράτες .	έχουν
« Τι θα [MASK] το ξέπλυμα είναι πιο φτηνό ; »	πει
Δε μας [MASK] άλλο από το να περιμένουμε τους λιμενικούς .	μένει
Τη [MASK] ο Βλασόπουλος .	ρωτάει
Να [MASK] σχέση αυτός με τη μαφία είναι απίθανο .	έχει
« Μα πού [MASK] όλη μέρα ; »	είσαι
« Ποιες [MASK] οι έκτακτες περιπτώσεις ; »	ήταν
με [MASK] ο Παπαδάκης .	ρωτάει
Μήπως όμως [MASK] τρομοκρατικές ενέργειες εκβιασμού , για να γυρίσουν οι εφοπλιστές σ την Ελλάδα ;	ήταν
« Μα δεν [MASK] κάτι προς ενημέρωση , κύριε υπαρχηγέ » ακούω τον Γκίκα .	υπάρχει
με [MASK] ο Φάνης .	ρωτάει
Τι περισσότερο [MASK] ο Σωτηρόπουλος και ήταν τόσο βέβαιος ότι η ασφάλεια δε θα πλήρωνε ;	γνώριζε
Εκεί που προκύπτουν περισσότερα ερωτήματα [MASK] ο πυροβολισμός .	είναι
[MASK] τα φαγητά με το κρασί και πριν σηκώσουμε τα ποτήρια , ο Φάνης κοιτάζει την Κατερίνα , σαν να θέλει να της πει « μίλα , γιατί τους έσκασες » .	Έρχονται
« Ως τώρα δεν έχει [MASK] κάποιο στοιχείο που να το επιβεβαιώνει » .	προκύψει
τον [MASK] η Κούλα .	ρωτάει
« Αλλά μετά [MASK] η Αδριανή » .	απαντάει
με [MASK] ο Μερίκας , που έχει αντικαταστήσει τον Σωτηρόπουλο .	ρωτάει
« Πώς [MASK] οι δικοί σου ; »	είναι
[MASK] η Αδριανή και σταυροκοπιέται , χωρίς το « μνήσθητί μου , Κύριε » .	Απορεί
Εκεί πάνω [MASK] το τηλέφωνο και επαληθεύεται η ρήση « άλλαι μεν βουλαί ανθρώπων , άλλα δε Θεός κελεύει » .	χτυπάει
« Πότε [MASK] η οικογένεια να πάρει τον νεκρό ; »	μπορεί
[MASK] ο Βλασόπουλος .	αναρωτιέται
[MASK] αρχές Μαΐου , το βράδυ είναι γλυκό και οι πιστοί , που είναι συγκεντρωμένοι μπροστά σ την εκκλησία , ακούνε τη λειτουργία από τα μεγάφωνα και ψιλοκουβεντιάζουν .	Είναι
Ευτυχώς δεν [MASK] πολλά και τελειώνω γρήγορα , γιατί η προσπάθεια με παραλύει .	είναι
« Ενώ το να μαγειρεύεις [MASK] μια απόλαυση κι εκεί πάνω τα καταπίνεις πιο εύκολα » .	είναι
Tον [MASK] ο Δερμιτζάκης , όταν έχουν φύγει οι Γεωργιανοί .	ρωτάει
Δεν [MASK] όμως Σεργκέι σ την Ταϊλάνδη και πρέπει να βρω άκρη απ' αλλού .	υπάρχει
[MASK] και οι δυο τα γέλια .	Βάζουμε
τη [MASK] ο Δερμιτζάκης .	ρωτάει
Από το « καλά , μαλάκας [MASK] ο Χαρίτος ; » , ως το « ποιος ξέρει πόσα άλλα ράμματα είχαν για τη γούνα του » .	είναι
[MASK] ο Παπαδάκης .	απορεί
Τώρα [MASK] εννιά το πρωί , Τρίτη του Πάσχα , και πηγαίνω σ την υπηρεσία με το Σέατ .	είναι
τον [MASK] ο Φάνης .	ρωτάει
τη [MASK] το παλικάρι με το μακό μπλουζάκι .	ρωτάει
Λοιπόν , [MASK] και οι δυο , Κώστα .	χάσαμε
« [MASK] η εταιρεία που έχει νομικό σύμβουλο την Κατερίνα » μου λέει αμέσως .	Είναι
[MASK] ο Βλασόπουλος τον Δημητριού .	ρωτάει
[MASK] και σηκωνόμαστε κι εμείς .	Σηκώνεται
[MASK] ανάγκη να κάνετε τόση φασαρία ;	Ήταν
« [MASK] , και τα καΐκια , τα κότερα και τα τρεχαντήρια ; »	Καλά
« Σπάνια [MASK] το ίδιο άτομο » .	ήταν
Για καλή μου τύχη , με [MASK] σ το ενδιάμεσο ο Δημητριού , για να μου πει ότι , σύμφωνα με τον κλειδαρά , το σύστημα ασφαλείας έχει παραβιαστεί , αλλά αυτός που το έκανε θα πρέπει να ήταν μάστορας , γιατί εκ πρώτης όψεως δε φαίνεται τίποτα .	παίρνει
Και όταν ο μπαμπάς μεταφέρθηκε σ τη δευτέρα παρουσία , [MASK] και ο γιος την επιχείρηση σ την Ελλάδα .	μετέφερε
μου [MASK] ο Βλασόπουλος .	λέει
Προφανώς [MASK] τα γραφεία των προϊσταμένων .	είναι
« [MASK] οι εκπρόσωποι του μαύρου χρήματος , κύριε αστυνόμε » .	Είμαστε
« Ποιοι [MASK] εσείς ; » τον ρωτάω .	είστε
« Πράγματι [MASK] η Ελλάδα » μου λέει με το φαρμακερό ύφος της .	αλλάζει
« Πού [MASK] οι Γεωργιανοί ; »	έμεναν
[MASK] όμως φορές που έφταναν με το καΐκι ή που περνούσαν μαζί του σ την Ερέτρια .	Υπήρχαν
« Τα [MASK] κι εσείς ; »	ξέρατε
Εκτός από γεμιστά , [MASK] και μια πιατέλα με φασολάκια , που ξέμειναν από χτες .	υπάρχει
« Να [MASK] παιδί η Κατερίνα ; »	κάνει
[MASK] ενδείξεις για να ψάξει κανείς παραπέρα , και αυτό έκανα .	Είναι
« Τι θα [MASK] αυτό ; »	πει
Κάθε φορά που παίρνω την απόφαση να χαλαρώσω , [MASK] ο διάολος το πόδι του και μου τα χαλάει .	βάζει
Σ το τέλος θα [MASK] το γνωστό ερώτημα : τι κάνει η αστυνομία ;	μπει
[MASK] η Μάνια .	απορεί
[MASK] το περιπολικό και τους έπιασε επ' αυτοφώρω , την ώρα που το άδειαζαν .	Πήγε
Σ την αστυνομία [MASK] ο πατέρας σου , δε δουλεύει σ την πολεοδομία , για να κάνει τα στραβά μάτια σ την παράνομη δόμηση .	δουλεύει
« Ναι , αλλά έμεινε στάσιμος υπέρ πίστεως και πατρίδος » της [MASK] η Κατερίνα , με το ίδιο έξαλλο ύφος .	απαντάει
Σ ' εμένα δε [MASK] τίποτα .	μένει
« [MASK] γκιορτή που όλοι εκκλησία » συμπληρώνει ο Αφγανός .	Πήγκαμε
Έτσι καλοδιάθετη [MASK] και η « καληνύχτα » μας .	είναι
[MASK] η Μάνια .	Φωνάζει
Τον [MASK] ο Δερμιτζάκης .	ρωτάει
Του [MASK] ο Δερμιτζάκης .	λέει
Τη [MASK] ο Ούλι .	ρωτάει
Μας [MASK] η σύζυγος Πετράκη .	ανοίγει
με [MASK] ο Ούλι .	ρωτάει
Δεν [MASK] κανένας άλλος μαζί μας .	ήταν
« Τόσο [MASK] ήταν μια υπόθεση , που οι δράστες της ομολόγησαν και βρέθηκαν τα όπλα του εγκλήματος ; »	δύσκολη
Το επόμενο [MASK] είναι μια επίσκεψη σ το χώρο εργασίας του Λαλόπουλου .	βήμα
Το ίδιο [MASK] άλλωστε και το λιμενικό , που είναι και το μόνο ικανό να ξεδιαλύνει το κουβάρι .	πιστεύει
[MASK] η Αδριανή .	αναρωτιέται
« Μπράβο , Ούλι , παιδί μου » [MASK] η Αδριανή .	ενθουσιάζεται
Γι ' αυτό [MASK] η ασφάλεια .	υπάρχει
« Μόλις [MASK] ο Σταυρόπουλος » .	επιστρέφει
Πού [MASK] τώρα οι Γεωργιανοί ;	βρίσκονται
« Έτσι [MASK] και η προηγούμενη καταστροφή » μας εξηγεί .	άρχισε
[MASK] η Κούλα τον Στεργιάδη .	ρωτάει
« Τι [MASK] αυτός ο Χαρδάκος ; »	ήταν
[MASK] οι συστάσεις .	Ακολουθούν
[MASK] είναι ο αποκλειστικός στόχος της πρότασης αυτής .	Αυτός
Σ τη βόρεια πλευρά του Παγγαίου , απέναντι από τη Δράμα , σ' ένα κατάφυτο πέταλο με αμφιθεατρική θέα και σε ύψος 350 μέτρων , [MASK] ένα σύμπλεγμα γραφικών χωριών .	βρίσκεται
[MASK] διάφορες εκδοχές για την ετυμολογία του ονόματός της .	Υπάρχουν
Επίσης , σ το νησί [MASK] χώρος εκπαίδευσης προσκόπων και ναυτοπροσκόπων σ τη φυσική ζωή .	λειτουργεί
Επίσης , σ το νησί [MASK] το μνημείο των Σέρβων στρατιωτικών , που έστησε η Σερβική κυβέρνηση , αλλά και η ιστορική εκκλησία του Αγίου Στεφάνου .	υπάρχει
Η πρώτη [MASK] είναι οι συνθήκες άκρας ένδειας υπό τις οποίες ζουν χιλιάδες άνθρωποι , όχι μόνο σ τη συγκεκριμένη ανατολική περιφέρεια , αλλά σε όλη την επικράτεια της Λαϊκής Δημοκρατίας του Κονγκό , μιας ένδειας που επιδεινώνεται ακόμη περισσότερο λόγω της εμπόλεμης κατάστασης που μαστίζει αυτή τη χώρα από το 1996 .	πραγματικότητα
Από την άποψη αυτή , [MASK] εξαιρετικά επίκαιρο το ψήφισμα που εγκρίναμε αυτή την εβδομάδα και που διασυνδέει τη βοήθεια έκτακτης ανάγκης , την αποκατάσταση και την αναπτυξιακή πολιτική .	υπήρξε
Η δεύτερη [MASK] είναι το μίσος που σιγοφούντωνε μεταξύ των λαών της ανατολικής περιφέρειας και του γειτονικού πληθυσμού της Ρουάντα , ένα μίσος που εκφράστηκε με την άρνηση του πληθυσμού της Γκόμα να δεχθεί τη φιλοξενία που προσέφερε η Ρουάντα και με τη μαζική επιστροφή αυτού του πληθυσμού σ τα εδάφη του , που είχαν ήδη κατακλυσθεί από το ηφαίστειο , παρά τον κίνδυνο νέας έκρηξης .	πραγματικότητα
Αποτέλεσμα της έκρηξης [MASK] ο θάνατος πέντε ατόμων , καθώς και ο τραυματισμός δεκαπέντε ανθρώπων .	αποτέλεσε
Πιο συγκεκριμένα , έντονες αντιδράσεις [MASK] η πρόταση για γενικό αφοπλισμό , από τον οποίο όμως θα εξαιρούνταν η Τρίτη Ελληνική Ορεινή Ταξιαρχία και ο Ιερός Λόχος με το σκεπτικό ότι ήταν το μόνο εν λειτουργία τμήμα του τακτικού Ελληνικού Στρατού το οποίο πολέμησε σε Βόρειο Αφρική και Ιταλία .	προκάλεσε
[MASK] επίσης μέλη αντιστασιακών και άλλων οργανώσεων όπως η ΠΕΑΝ , η Ιερή Ταξιαρχία , η ΡΑΝ , η φοιτητική ΕΣΑΣ , η Εθνική Δράση , ο ΕΔΕΣ Αθηνών , η φιλοβασιλική Χ και άλλες μικρότερες ομάδες .	Συμμετείχαν
Επίσης κατά την διάρκεια των Δεκεμβριανών [MASK] η οργάνωση του ΚΚΕ ΟΠΛΑ , τα μέλη της οποίας δολοφόνησαν μεγάλο αριθμό αντιφρονούντων μεταξύ των οποίων και πολλούς Τροτσκιστές , όπως περιγράφει ο τροτσκιστής Στίνας σ το βιβλίο του ΕΑΜ-ΕΛΑΣ-ΟΠΛΑ .	έδρασε
Σ τα [MASK] οι εμπλεκόμενοι αστυνομικοί σ το κύκλωμα ναρκωτικών .	δικαστήρια
Σ τα δικαστήρια της Θεσσαλονίκης [MASK] προς απολογία σ τον ανακριτή οι εννιά τελευταίοι κατηγορούμενοι , από το σύνολο των 35 που είχαν συλληφθεί για συμμετοχή σε εμπορία ναρκωτικών που εξαρθρώθηκε από την Ασφάλεια Θεσσαλονίκης .	προσήλθαν
Η νέα στρατιωτική συμφωνία που υπεγράφη με τις Φιλιππίνες δεν έχει σκοπό τον έλεγχο της Κίνας , [MASK] ο Πρόεδρος Ομπάμα κατά τη διάρκεια συνέντευξης Τύπου με τον Πρόεδρο των Φιλιππίνων Μπενίνιο Ακίνο .	δήλωσε
Κορυφαίος [MASK] ήταν η εμπλοκή της Μεγάλης Βρετανίας σ την αντίσταση με πρωτεύοντα στόχο τον πόλεμο κατά του άξονα αλλά και με δευτερεύοντα στόχο να ελέγξει τις μεταπολεμικές πολιτικές εξελίξεις σ την Ελλάδα .	παράγων
Σημαντικό επιβαρυντικό [MASK] ήταν η απουσία μιας δημοκρατικά νομιμοποιημένης αρχής που θα διηύθυνε τον αντιστασιακό αγώνα εξ ονόματος του ελληνικού λαού .	στοιχείο
Σ το εσωτερικό της Ελλάδος , την αντίσταση [MASK] διαφορετικές οργανώσεις με αντίθετο μεταξύ τους πολιτικό προσανατολισμό .	διεξήγαν
Η μεγαλύτερη αντιστασιακή [MASK] ήταν το ΕΑΜ και το στρατιωτικό του παρακλάδι , ο ΕΛΑΣ που είχε ιδρυθεί με πρωτοβουλία του ΚΚΕ αλλά σ την μεγαλύτερη του ακμή είχε σ τις γραμμές του κατά πλειοψηφία μη κομμουνιστικά μέλη .	οργάνωση
[MASK] ακόμη ο ΕΔΕΣ με επικεφαλής τον Ναπολέοντα Ζέρβα που συσπείρωνε πλήθος αξιωματικών του προπολεμικού ελληνικού στρατού , η σοσιαλδημοκρατική ΕΚΚΑ καθώς και άλλες οργανώσεις .	Υπήρχαν
Σ την υπηρεσία του κατακτητή [MASK] από το 1943 , έτος που ιδρύθηκαν , τα Τάγματα Ασφαλείας .	πολεμούσαν
[MASK] , το Δεκέμβριο_του_1944 , τα " Δεκεμβριανά " σ την περιοχή της Αθήνας , ανάμεσα σ τους αντάρτες του ΕΛΑΣ και τις δυνάμεις που ήσαν πιστές σ την μόλις επαναπατρισμένη εξόριστη κυβέρνηση υπό την ηγεσία του Γ. Παπανδρέου και είχαν την υποστήριξη βρετανικών τμημάτων .	Ακολούθησαν
Σ το πλευρό των κυβερνητικών δυνάμεων [MASK] επίσης τα Τάγματα Ασφαλείας , μέλη της Οργάνωσης Χ ( χίτες ) και άλλες μικρότερες παραστρατιωτικές ομάδες .	πολέμησαν
Μετα το τέλος των Δεκεμβριανών και την συνθηκολόγηση του ΕΑΜ με την συμφωνία της Βάρκιζας [MASK] μία περίοδος κατά την οποία ομάδες της άκρας δεξιάς βρήκαν την ευκαιρία να προβούν σε πράξεις αντεκδίκησης εναντίον οπαδών του ΕΑΜ-ΚΚΕ ( περίοδος λευκής τρομοκρατίας ) .	επακολούθησε
Σήμερα , κοντά σ το χωριό Κρηνίδες , παλιό καπνοχώρι , [MASK] ο αρχαιολογικός χώρος των Φιλίππων .	βρίσκεται
Σ την πόλη [MASK] και το Αρχαιολογικό Μουσείο των Φιλίππων , το οποίο χτίστηκε το 1961 .	βρίσκεται
Το μοναδικό γκολ του αγώνα [MASK] ο Ξαντάο της Σπόρτινγκ Λισαβόνας .	πέτυχε
Για όσους ήταν εκτός , [MASK] άγνωστη η μεγάλη επιρροή που ασκούσε σ την κυβέρνηση Κάστρο ο Ερνέστο Τσε Γκεβάρα , Αργεντινός μαρξιστής και ένας από τους στενότερους συμβούλους του Κάστρο .	παρέμενε
Σ τα τέλη της δεκαετίας του 1960 [MASK] εμπορικό εμπάργκο σ την Κούβα , κάτι που ώθησε ακόμη περισσότερο τον Κάστρο σ τη Σοβιετική συμμαχία .	επιβλήθηκε
[MASK] αυτού ήταν η Εισβολή σ τον Κόλπο των Χοίρων τον Απρίλιο_του_1961 :	Αποτέλεσμα
Σ τα περίχωρα της πόλης [MASK] μνημεία και ερείπια που μαρτυρούν την ιστορία της , όπως τα τείχη της αρχαίας πόλης , η ακρόπολη , το αρχαίο θέατρο , η αγορά , το Ιερό του Διονύσου και ο Ναός του Πυθίου Απόλλωνα .	υπάρχουν
Σ την αρχή και σ το τέλος του , [MASK] οι πανάρχαιες ακροπόλεις της Οσντίνας και της Ραβενής .	στέκουν
Σε αυτό , [MASK] κανείς να φτάσει οδικώς από την Ηγουμενίτσα ή με καΐκι από τη Σαγιάδα	μπορεί
Η ισχυρότερη [MASK] εντός της χαλαρής αυτής ομοσπονδίας είναι η Αυστρία .	δύναμη
Με την γερμανική επίθεση κατά της Πολωνίας σ τις 1_Σεπτεμβρίου_1939 [MASK] ο Β' Παγκόσμιος Πόλεμος , ο οποίος για την Γερμανία λήγει σ τις 8_Μαΐου_1945 με συνθηκολόγηση άνευ όρων .	αρχίζει
Με την πτώση του σιδηρού παραπετάσματος σ την κεντρική Ευρώπη [MASK] και τα σύνορα μεταξύ δυτικής και ανατολικής Γερμανίας .	ανοίγουν
Την δεκαετία του '80 [MASK] η Ελλάδα , η Ισπανία και η Πορτογαλία .	εισέρχονται
Το 2001 [MASK] σε αυτήν και η Ελλάδα .	προσχώρησε
Ήμασταν [MASK] αυτοί που θα προτιμούσαν το 2020 να είναι ένας πιο σταθερός τελικός στόχος για την εκπλήρωση των συστάσεων της ΠΟΥ .	πολλοί
Θα [MASK] ενημέρωση των πολιτών γενικά αλλά και των πολιτών που ανήκουν σε ομάδες που είναι ιδιαίτερα ευαίσθητες όσον αφορά τα προβλήματα που προκαλούνται από αυτά τα αίτια .	γίνεται
Είναι ένα επίπονο [MASK] αυτό σ το οποίο επιδόθηκε η κ. Lucas και θέλω να τη συγχαρώ για την εργασία της .	έργο
Το δεύτερο [MASK] είναι η κυκλοφοριακή ρύπανση .	στοιχείο
η [MASK] , μεγάλης σημασίας κατά τη γνώμη μου , είναι η αντικατάσταση , μέχρι το 2020 , του 20% των κλασικών καυσίμων με καθαρότερα εναλλακτικά καύσιμα , είτε βιολογικά καύσιμα είτε ακόμη και υδρογόνο , θέτοντας ως ενδιάμεσο σταθμό όσον αφορά τη χρήση των βιολογικών καυσίμων το 2010 , με τον φιλόδοξο στόχο να αποτελούν τότε τα βιολογικά καύσιμα το 5,75% του συνόλου των καυσίμων που χρησιμοποιούνται σ την Ένωση .	πρώτη
Όσοι έβγαλαν τα χρήματά τους σ το εξωτερικό θα πρέπει να τα επιστρέψουν σ τις ελληνικές τράπεζες , [MASK] σε συνέντευξή του σε κυριακάτικη εφημερίδα ο Υπουργός Οικονομικών της Ελλάδας , Γιάννης Στουρνάρας , ξεκαθαρίζοντας μάλιστα πως δεν πρέπει να περιμένουν αμνήστευση των πράξεών τους .	τονίζει
Σε απόσταση 1,5 χιλιομέτρου από τον οικισμό [MASK] το μοναστήρι του Αγίου Ιωάννου του Θεολόγου του Μουγκού χτισμένο τον 15ο αιώνα περίπου , όπου υπηρέτησε ως εφημέριος ο λόγιος ιερομόναχος Παρθένιος Χαιρέτης , διδάσκαλος κωδικογράφων .	βρίσκεται
