Από την ίδρυσή του ως το 1453 το [MASK] το εξουσίαζαν οι Βυζαντινοί , σ τη συνέχεια ως το 1538 οι Ενετοί και ως το 1821 οι Τούρκοι , ενώ γύρω σ το 1660 πέρασε και πάλι σ τα χέρια των Ενετών .	Κάστρο
Προκειμένου να το ενισχύσουν , οι κάτοικοι [MASK] οχύρωσαν με τείχη , διάσπαρτα με πολεμίστρες και κανόνια , τα οποία ήταν ισχυρότατα και πανύψηλα .	το
Η Διεθνής Υπηρεσία Μελέτης του Καρκίνου ( IARC ) [MASK] έχει κατατάξει σ τις καρκινογόνες ουσίες τρίτης τάξεως , δηλαδή σ τις πιθανώς καρκινογόνες για τον άνθρωπο .	το
Όσον αφορά την αξιολόγηση των αποτελεσμάτων της Βαρκελώνης , θα [MASK] κρίνουμε επί τη βάσει του ελέγχου προόδου .	σας
Δεν πρέπει να [MASK] κάνουμε .	το
Η παρούσα οδηγία για την επαγγελματική κατάρτιση των επαγγελματιών οδηγών οδικών εμπορευματικών ή επιβατικών μεταφορών ουσιαστικά [MASK] έχει να αποτελέσει ένα συνοδευτικό μέτρο και να βελτιώσει την κατάσταση των συγκεκριμένων επαγγελματιών .	σκοπό
Εάν μία χώρα παρέχει ήδη κατάρτιση , δεν θα πρέπει να [MASK] τροποποιήσει τώρα εξαιτίας αυτής της οδηγίας .	την
Κυρία Αντιπρόεδρε Loyola de Palacio , [MASK] ενθαρρύνουμε να συνεχίσετε με αποφασιστικότητα τον δρόμο σας !	σας
Κατά τους ειδικούς , « [MASK] αυτών των τραγικών συμβάντων αποτελούν το αλκοόλ , η βία εντός της οικογένειας και οι κακές σχέσεις νέων - γονέων .	αίτια
Σ τους ναυάρχους [MASK] μετέφερε ο επικεφαλής της ελληνικής ναυτικής μοίρας Ράινεκ .	την
Εξαιτίας του δυστυχήματος σε τούνελ της Ελβετίας , σ το καντόνι του Wallis , τη [MASK] τους έχασαν οι δύο οδηγοί , 22 παιδιά και τέσσερις συνοδοί , ενώ επίσης τραυματίστηκαν άλλα 24 άτομα .	ζωή
Το άρθρο 9 του Πρωτοκόλλου , όπως επεσήμανε με αυστηρότητα η Πρόεδρος Fontaine σ τον Εισαγγελέα , [MASK] απαλλάσσει τελείως από οποιαδήποτε νομική διαδικασία σε σχέση με την έκφραση γνώμης ή ψήφου κατά την άσκηση των καθηκόντων μας ως μέλη αυτού του Κοινοβουλίου .	μας
« Ο υπουργός [MASK] περιμένει σ τις έντεκα σ το γραφείο του » .	μάς
Τα περί ανοιχτής πόρτας [MASK] έχω ακούσει απ' όλους ανεξαιρέτως , λέω μέσα μου .	τα
Όσα έχει περάσει σ τη ζωή του [MASK] κάνουν να βρίσκει πολλές φορές λύσεις , που οι άλλοι ούτε τις σκέφτονται .	τον
« Άμα πεινάνε [MASK] σκέφτομαι πιο πολύ » του απαντάει .	τα
« Ακόμα κι αν δε βρούμε , [MASK] φτάνει αν ταιριάζουν τα μαχαίρια σ τις πληγές και ότι είναι δικά σας » τους εξηγώ .	μας
« Και αν [MASK] καταφέρουμε ; »	τα
« Εσύ να [MASK] ακούς , που άφησες την αστυνομία για να κάνεις ελεύθερο επάγγελμα » λέει γελώντας η Κατερίνα σ τη Μάνια .	τ'
Από την άλλη , ο Παπαδάκης [MASK] είναι συμπαθής και δε με παίρνει να του πω όχι .	μου
« Και τώρα [MASK] κάνουμε ; »	τι
Τώρα , αν αυτό ήταν μίζα ή κάτι άλλο , δεν [MASK] ξέρω , αλλά κάπου θα βρούμε την άκρη , είτε εμείς είτε η Αρχή για το ξέπλυμα μαύρου χρήματος .	το
Σ τα χρόνια πριν από την κρίση , που η Ελλάδα υποτίθεται ότι πετούσε σ τα ύψη , όλοι αυτοί δεν [MASK] κουνούσαν από το Λονδίνο .	το
« Αλήθεια , ρε μαμά , [MASK] τα ήθελες τα ορεκτικά ; »	τι
Η ιδέα δε [MASK] τρελαίνει , γιατί έχω έρθει κουρδισμένος να περάσω μια ήσυχη μέρα .	με
« Και σ την Ηλιούπολη , [MASK] γύρευες ; »	τι
Όταν παντρευτεί την Κούλα και ζητήσει μετάθεση , θα [MASK] λείψει πολύ σκέφτομαι , καθώς παρακολουθώ το συλλογισμό του .	μου
Και ο οδηγός [MASK] παρακολουθούσε , για να ξεκαθαρίσει το ωράριό του και να διαλέξει το κατάλληλο σημείο για την εκτέλεση .	τον
« Και πού θα [MASK] τραπεζώσουν ; »	μας
Το τραπεζάκι ανάμεσά [MASK] είναι κι αυτό εξοχικό , με ένα άδειο βάζο για λουλούδια πάνω του .	τους
« Μόλις πήρε τα λεφτά από την πώληση του υπολογιστή , ο Μαχμούντ [MASK] μετέτρεψε σε χρυσαφικό » .	τα
« Όλα τ' άλλα [MASK] ήξερε ήδη από σας » .	τα
Έστω και αν βούλιαξαν με δολιοφθορά , [MASK] θα κέρδιζαν αυτοί που τα βούλιαξαν από το φόνο του Χαρδάκου ;	τι
« Τελευταία φορά [MASK] είδα το βράδυ που τον εκτέλεσαν » .	τον
Ο πατέρας μου [MASK] γνώρισε , όταν υπηρετούσε ανθυπολοχαγός , και την ερωτεύτηκε .	την
« Εδώ δεν [MASK] σκότωσαν όταν τους ενοχλούσε , και θα τον σκότωναν συνταξιούχο ; »	τον
Παλιά , αυτά τα [MASK] τα φορούσαν οι φτωχοί σ τις συνοικίες που έφαγα τη ζωή μου .	κουρέλια
Σ την αρχή [MASK] παίζουν χαμηλών τόνων , ότι δήθεν θέλουν να μάθουν από σένα , και σε λίγο σε καβαλάνε .	το
« Ως τώρα ο πολίτης [MASK] ψήφιζε και άλλα γίνονταν » .	άλλα
Μπροστά σ την εκκλησία [MASK] περιμένουν η Μάνια με τον Ούλι .	μάς
Εάν κάποιος εκπροσωπεί μια μικρή αντιπροσωπεία σε μια μεγάλη Ομάδα , ή μια εναλλακτική θέση , τότε οι κοινοβουλευτικοί εκπρόσωποι της Ομάδας σπανίως [MASK] αφήνουν να μιλήσει .	τον
Το μόνο ερώτημα είναι πώς θα [MASK] υλοποιήσουμε καλύτερα .	την
Ανάμεσα σ τα στενά δρομάκια , τα ασβεστωμένα σκαλιά , τα ολόλευκα σπίτια σε σχήμα κύβου και τις δεκάδες εκκλησίες , την [MASK] σας θα τραβήξουν οι διάσημοι φλάροι , τα ιδιαίτερα κεραμικά της Σίφνου που τοποθετούνταν σ τις καπνοδόχους των σπιτιών .	προσοχή
Αυτό που είδαμε σ το παρελθόν όσον αφορά τέτοιου είδους επιτροπές δεν [MASK] άρεσε :	μας
« Καλέ , [MASK] έμαθα από μια φίλη μου που μένει σ το Χαλάνδρι » .	τα
« Κι εσύ [MASK] είπες ; »	τι
« Η γυναίκα μου δεν [MASK] χώνευε , γιατί είχε βάλει σ το στόχαστρο τη Χρυσή Αυγή » μου εξηγεί και σωπαίνει .	τον
« Δε θα [MASK] βρίζουν , γιατί η οικονομία έχει σταθεροποιηθεί » .	μας
Ίσως επειδή οι βοηθοί μου [MASK] βλέπουν βυθισμένο σε σκέψεις και αποφεύγουν τη φλυαρία .	με
Κανένας από το αντρόγυνο δε [MASK] συνοδεύει .	μας
Το σπίτι μου [MASK] νοίκιασα σε κάτι Ρωσοπόντιους .	το
Αν η Αδριανή απογοητεύτηκε από την είδηση , δεν [MASK] δείχνει .	το
« Από παιδί τα [MASK] ακούω » εξηγεί σ τον Φάνη .	ίδια
Η εταιρεία δεν [MASK] είχε σ την ασφάλεια .	τον
« Κύριε αστυνόμε , εμείς [MASK] περιμένουμε κάτω » λέει ο Παπαδάκης και κάνει νόημα σ τους άλλους να φύγουν .	σας
« Πώς , [MASK] θυμάμαι » μου απαντάει δίχως να διστάσει .	τον
« Αν παρ' ελπίδα σκαλώσουμε , θα [MASK] καλέσω » .	τον
« Να του [MASK] πεις ακριβώς όπως τα είπες και σ' εμένα » με συμβουλεύει .	τα
Όταν τελειώνω , [MASK] κοιτάζει για λίγο , κι ανοίγει το στόμα του .	με
Τόσον καιρό τρώνε κάθε βράδυ σ' εμάς και τώρα , που φάνηκε λίγο φως σ την άκρη του τούνελ , αυτοί [MASK] πήραν για ηλιοφάνεια και θέλουν να μας κάνουν το τραπέζι .	το
Αυτά που σου είπε ο γιος του για τα δύο ατυχήματα σε πλοία τους [MASK] ακούγονται τελείως λογικά .	μου
« Εντάξει , αλλά άλλο να [MASK] διαβάζω και άλλο ν' ακούω εμένα να τα λέω » .	τα
« Τα μαχαίρια τι [MASK] θέλατε ; »	τα
Ο ήχος του κινητού μου [MASK] ειδοποιεί ότι έχω μήνυμα .	με
« Αν το στικάκι δεν έχει σχέση με την έρευνα , θα της [MASK] επιστρέφω » .	το
Ο κύριος Χαρδάκος [MASK] προτιμούσε , γιατί ήταν πιο κοντά σ τον Πειραιά .	το
« Βαρβάρα , δε θα [MASK] κεράσεις σήμερα , που πήραμε αυξήσεις ; »	μας
« Όχι , δε θα [MASK] ρωτήσω » .	σε
Όταν φτάνει σ την κλειδαριά του σπιτιού , [MASK] πιλατεύει για λίγο και μετά γυρίζει σ' εμάς .	την
« Με την κυβέρνηση εθνικής ενότητας θα [MASK] καταφέρουμε » .	τα
« Λοιπόν , παιδιά , [MASK] σας λέω » .	ένα
Όλες αυτές οι σκέψεις [MASK] βασανίζουν από χτες το απόγευμα , που γύρισα σ το σπίτι και άνοιξα τον Δημητράκο .	με
Αυτή η εμμονή [MASK] καταδίκασε να μείνω στάσιμος , γιατί τα πάνω κλιμάκια δε με θεωρούσαν « συνεργάσιμο » , που σημαίνει ότι δεν ακολουθούσα τους κανόνες και έκανα του κεφαλιού μου .	με
« Και τα όσπρια δε [MASK] πείραξαν καθόλου σ το στομάχι ; »	σε
« Άλλη φορά να [MASK] παίρνει τηλέφωνο , πριν κανονίσει έξοδο » της λέει γελώντας ο Φάνης .	σε
« Όσοι κατέθεσαν τις πινακίδες τους , γιατί δεν είχαν να πληρώσουν τα τέλη κυκλοφορίας , τώρα [MASK] παίρνουν πίσω » σχολιάζει ο Παπαδάκης .	τις
« Δε θα [MASK] πειράξουμε » .	σε
Συνεπώς , αν υπήρχε κάτι , θα [MASK] είχαμε εντοπίσει » .	το
Και από πού [MASK] ήρθε ;	μας
« Ακόμα δε [MASK] έκαναν αύξηση » τον πειράζει ο Λερμιτζάκης .	μας
Η σκέψη ότι δεν αντέχω να περάσω μπροστά από το γραφείο μου , [MASK] ήρθε αργότερα .	μού
Οι δύο αυτές πραγματικότητες θα πρέπει να [MASK] οδηγήσουν σε μια στρατηγική και μια δράση της Ευρωπαϊκής Ένωσης που θα μας επιτρέψουν να παρέμβουμε σε αυτήν την περιοχή .	μας
Πιο συγκεκριμένα , έντονες [MASK] προκάλεσε η πρόταση για γενικό αφοπλισμό , από τον οποίο όμως θα εξαιρούνταν η Τρίτη Ελληνική Ορεινή Ταξιαρχία και ο Ιερός Λόχος με το σκεπτικό ότι ήταν το μόνο εν λειτουργία τμήμα του τακτικού Ελληνικού Στρατού το οποίο πολέμησε σε Βόρειο Αφρική και Ιταλία .	αντιδράσεις
Σ το εσωτερικό της Ελλάδος , την [MASK] διεξήγαν διαφορετικές οργανώσεις με αντίθετο μεταξύ τους πολιτικό προσανατολισμό .	αντίσταση
Το γεγονός αυτό [MASK] ανέδειξε σε μητρόπολη του Χριστιανισμού .	την
Το 2008 το [MASK] υιοθέτησαν και οι Κύπρος και Μάλτα .	ευρώ
