Jos joku repsottaa , on murtumassa , meinaa tipahtaa , on irronnut , minä [MASK] vaihdan .	sen
Sen lisäksi , että säästin Tukholmassa rahaa , tänä aamuna eräs myöhästynyt [MASK] oli siirretty tililleni .	palkkio
Marraskuun 1. päivän 2010 jälkeen rekisteröityneille nämä [MASK] otetaan käyttöön kuuden kuukauden kuluttua rekisteröitymisestä .	rajoitukset
Nuo Facebook / Wordpress [MASK] muutin nollille , sillä backlinkkien määrä liikkui miljardeissa ja ne vääristävät dataa todella paljon .	–arvot
Puolueen etusivuille vievien osoitteiden [MASK] ei ole nollattu .	arvoja
- Mitämitä , Lasarin [MASK] ja Alko avattu ? ! ? !	S-market
Ja juhlavampia , kesäisempiä [MASK] en omistakaan , joten noille toisille oli tilausta .	korkkareita
Näitä seesamin- ja unikonsiemenillä koristeltuja [MASK] en ole itse tehnyt , kylläkin aktiivisesti mukana ollut ... .	juustopalloja
... ja näin minä tämän [MASK] tein ... .	seiruoan
Tämä 5 e ( muistaakseni ) maksanut [MASK] nautittiin puolitettuna siskon kanssa Rukan reissulla Kuusamon Prisman kahviossa .	lohipiirakkapalanen
Kyllä minäkin mieluummin komeaa [MASK] katselen , kuin jotain suihkut onnistuneesti paennutta mörköä .	miestä
Känsilläni , ugh , [MASK] höyläsin ja nyrkein sen naulasin .	lankun
Mikäli ette itse savusta , niin savustettua [MASK] ( muukin kala käy ) saa lähes jokaisesta kaupasta .	kirjolohta
Taloudelliset ja strategiset [MASK] on valitettavasti aikaisemmin asetettu liian usein demokratian ja ihmisoikeuksien edelle .	edut
Kaikki eläinten rehuksi tarkoitetut [MASK] määritellään nyt yhteisellä termillä kaikissa eläinten rehuja koskevissa lainsäädännöissä .	tuotteet
Tämän vuoksi kaikki Etiopian prosessia koskevat [MASK] voidaan käsittää väärin , kuinka rakentavia ja hyvää tarkoittavia ne sitten ovatkaan , niin kuin tämä parlamentin aloite tietenkin on , tai ne , jotka pyrkivät keskeyttämään Etiopian demokratisoitumisprosessin , voivat käyttää niitä noiden katalien tarkoitusperiensä edistämiseen .	mielenilmaisut
Kolmanneksi , mitä suurlähettiläiden arvioihin tulee , ystävällismielisiä [MASK] kyllä käytiin , ainakin siinä kokouksessa , johon minä osallistuin , mutta haluaisin tietää , miten on mahdollista , että kaikkien hallitusten mielipide , Saksan varauksen huomioon ottaen , oli jäsen Martínezin mukaan täysin päinvastainen kuin suurlähettiläiden ilmaisema kanta : nämä kannattivat ehtoja asettelematonta vuoropuhelua , hallitukset taas puolsivat niinkin kauan sitten kuin joulukuussa annetun yhteisen kannan säilyttämistä .	keskusteluja
Saamiemme tietojen mukaan , jotka Air France -lentoyhtiö vahvisti saapuessani tähän rakennukseen , kaikki tämän viikon [MASK] on peruutettu .	lennot
Vapaan kaupankäynnin turmiolliset [MASK] ovat helposti nähtävissä tässä asiassa eikä 38 kohta tässä suhteessa ole riittävä .	seuraukset
Euroopan parlamentin ensimmäinen [MASK] suoritettiin ilman mietintöä , kun taas toisen käsittelyn tarkistusehdotukset liittyivät komitologiamenettelyyn ja väliaikaisen järjestelyn käyttöön ottamiseen , josta äskettäin keskustelimme .	käsittely
Näistä opettajista riippuvaisia [MASK] uhkaa todellakin köyhyys .	perheitä
Ja tason nostamiseksi [MASK] syöstään pakkokeinojen kierteeseen , joka olisi voitu välttää , jos alun perin olisi pyritty yksimielisyyteen .	Eurooppa
Arvoisa puhemies , arvoisa neuvoston puheenjohtaja Lehtomäki , arvoisa komission jäsen Frattini , Länsi-Balkanin [MASK] eristetään viisumivaatimuksilla , ja tämä on surullista näiden maiden kannalta .	maat
Henkilökohtaiset ja yksityiset [MASK] on jätettävä taka-alalle .	asiat
Eräs erikoisuus oli , että [MASK] otettiin neuvostossa vastaan yksimielisesti , ja siksi olen hieman onneton siitä , että myös sosialistien äänillä , jotka eivät muuten sanoneet sitä ensimmäisessä käsittelyssä , urheilijoiden ravinto otetaan kuulemma jälleen pois .	asia
Monivuotisten ohjausohjelmien korkeista kustannuksista huolimatta niiden [MASK] ei ole saavutettu .	tavoitteita
Näin ollen tänään puolenpäivän aikaan pidettyjä [MASK] ei voi kyseenalaistaa , vaan ne katsotaan hyväksytyiksi .	äänestyksiä
EU: n historian ja EU: n kulttuurin [MASK] otetaan käyttöön ennemmin kuin eurooppalaisen historian ja eurooppalaisen kulttuurin tai vaikkapa muiden maailman osien maailmanhistorian ja kulttuurien opetusta .	opetusta
Esittelijä Oomen-Ruijtenin mietinnössä [MASK] perustellaan vakuuttavasti .	tämä
Arvoisa puhemies , EY:n perustamissopimuksen 226 artiklan mukaista jäsenyysvelvoitteiden noudattamatta jättämistä koskevaa [MASK] sovelletaan jäsenvaltioihin , jotka eivät ole ilmoittaneet komissiolle täytäntöönpanotoimistaan tai ovat ilmoittaneet niistä ainoastaan osittain .	menettelyä
Koska komissio odottaa lukuisien jäsenvaltioiden ilmoittavan lainsäädännöstään komissiolle ennen tämän vuoden loppua , tällainen [MASK] voidaan antaa vasta vuoden 2006 kuluessa .	arvio
1. syyskuuta lehtimies [MASK] Hamid kiskottiin ulos autostaan ja pahoinpideltiin .	Tai
Parlamentin jäsen Rothe [MASK] sanoi ilmoittaessaan , että 12 % ei riitä .	sen
Tällä hetkellä asianomaista [MASK] säännellään kahdenvälisillä open skies -sopimuksilla .	lentoliikennettä
Jos vieressä olisi selkä , [MASK] voisi hivellä hiljaa ja sitten vähän vaativammin , kunnes joku kääntyisi ja hyväilisi yön aamuksi , mutta ei .	sitä
Niin , pitihän [MASK] arvata , että se on se mies .	se
Kun eihän hän tietenkään sitä [MASK] varsinaisesti katso verhojen raosta .	miestä
Ei Harmaa tyttö [MASK] sentään avaa , vaan palauttaa kiltisti paikalleen oikeaan laatikkoon .	niitä
Vielä enemmän alemmuudentuntoiseksi [MASK] on saanut liiallinen Bukowskin lukeminen .	minut
En minä kyllä oikeastaan [MASK] kaipaa .	sitä
” Mistä te [MASK] voitte tietää ? ”	sen
” Jumalan Keskushermosto [MASK] sanoi , ja sen jälkeen koko Suolisto on vääntelehtinyt jännityksestä !	sen
Vaikka eipä tilanteessa juurikaan voinut [MASK] tehdä .	mitään
Nyt ei ollut yhtään [MASK] hukattavissa .	aikaa
- En minä [MASK] arkkuun ole laittamassakaan , auta siirtämään sitä .	sinua
- Milläs minä [MASK] estäisin ?	teitä
- Moi , [MASK] kuuntelet ? kysyt vilpittömästi	mitä
En yhtää nyt sun [MASK] tajuu .	juttuus
Jos tämä ei riitä , [MASK] me sitten tehdään ?	mitä
Emme me voi [MASK] sinulle kertoa , täytyyhän sinun se ymmärtää , rakas lapsi .	sitä
Kahden viikon kuluttua [MASK] siirretään ottovanhempiensa luokse .	lapsi
vapaille ja demokraattisille vaaleille otolliset [MASK] voidaan luoda kahdesta kolmeen kuukaudessa .	olosuhteet
Kovin korkeallepa sinä [MASK] arvostat	häntä
Nenä ja paikallislehti [MASK] kertovat : Valkeakoski on muka ollut suoranainen hajuhelvetti elokuussa .	sen
Jälkiruokaan ehdittyä ikävät [MASK] unohdettiin .	asiat
Ai ai , kylläpäs [MASK] nyt kouriikin , Muori ähkäisi .	minua
Mentaalisten ja tunneverbien [MASK] erottaa muista täydennyksistä erityisesti tajunnallisuuteen liittyvät eli kokijan ominaisuudet .	subjektin
Alkuaan kuvankaunis yhteiskoulun [MASK] on tärvätty uudisrakentamisella .	rakennus
Lontoon Heathrow ´ n ja Gatwickin [MASK] Englannissa suljettiin myöhään sunnuntai-iltana pommiuhkausten vuoksi ja kaikki lennot Lontoon pääkentille keskeytettiin toistaiseksi	lentokentät
Kyllä sinä nyt [MASK] keitit .	sopan
Samanlaisia vaikka pienempiä [MASK] " demokratian puolesta " pidettiin kaikissa Argentiinan suurissa kaupungeissa .	mielenosoituksia
Siis sitä Malmion [MASK] sitä ollaan etsiskelemässä .	talkkunapäätäkö
Koska kaloja on tuotu ei-hyväksytyiltä alueilta , [MASK] olisi sovellettava neljän vuoden ajan hyväksymispäivämäärästä .	ohjelmaa
( 5 ) Jotkin päätöksessä 2003/634/EY hyväksytyt , Ranskaa ja Saksaa koskevat [MASK] on jo saatettu päätökseen .	ohjelmat
( 6 ) [MASK] 2003/634/EY olisi tämän vuoksi muutettava vastaavasti .	Päätöstä
Jos yhteisön ulkopuoliset lentoliikenteen harjoittajat huolehtivat kaikista kuljetuksista , 1 ja 2 [MASK] sovelletaan vain yhteisöön , yhteisöstä tai sen sisällä tehtäviin kuljetuksiin . "	kohtaa
Matkustajan kuolemantapauksen ja loukkaantumisen osalta [MASK] ei ole rahamääräisesti rajoitettu .	korvausvastuuta
Matkustajan viivästymisen aiheuttamien vahinkojen osalta [MASK] rajoitetaan 4150 erityiseen nosto-oikeuteen ( likimääräinen summa paikallisena valuuttana ) .	korvausvastuu
( 4 ) direktiivissä 78/546/ETY säädettyä [MASK] olisi tämän vuoksi muutettava , jotta varmistetaan erityisesti se , että yhteisön sisäisten kuljetusten alueellinen alkuperä ja määräpaikka kuvataan samoin perustein kuin kansallisissa kuljetuksissa , ja jotta luodaan yhteys tavarakuljetusten ja ajoneuvoilla kuljettujen matkojen välille mittaamalla näissä kuljetuksissa käytettävien ajoneuvojen käyttöaste ,	järjestelmää
( 8 ) tilastotietojen asianmukainen [MASK] on varmistettava ,	levittäminen
( 11 ) päätöksellä 89/382/ETY/Euratom ( 6 ) perustettua [MASK] on kuultu kyseisen päätöksen 3 artiklan mukaisesti ;	tilasto-ohjelmakomiteaa
2. Kuhunkin alaan liittyvät tilastolliset [MASK] , niiden määrittely ja niiden erittelyyn käytettyjen nimikkeistöjen tasot esitetään liitteissä .	muuttujat
4. Tietojenkeruun tunnusmerkkien [MASK] ja liitteiden sisältö vahvistetaan 10 artiklassa säädettyä menettelyä noudattaen .	mukauttaminen
2. Edellä 1 kohdassa tarkoitettujen tietojen sekä tarvittaessa kyseisiin tietoihin perustuvien taulukoiden toimittamista koskeva [MASK] vahvistetaan 10 artiklassa säädettyä menettelyä noudattaen .	menettely
5. Edellä 4 kohdassa tarkoitetun siirtymävaiheen [MASK] vahvistetaan 10 artiklassa tarkoitettua menettelyä noudattaen heti kun tekniset edellytykset mahdollistavat tehokkaan alueellisen koodauksen sekä kansallisen että kansainvälisen tavaraliikenteen osalta liitteessä G olevien 1 ja 2 kohdan mukaisesti .	päättymispäivä
Maanteiden tavarakuljetuksia koskevien tilastollisten tulosten levitystä koskevat [MASK] , mukaan lukien levitettävien tulosten rakenne ja sisältö , määritellään 10 artiklassa säädettyä menettelyä noudattaen .	säännökset
Ottamatta tässä huomioon kansallisten yhteyspisteiden varsinaiseen perustamiseen liittyviä henkilöstö- , toimitila- ja tietotekniikkajärjestelyitä , EMN:n toiminnan keskeiset [MASK] vuodesta 2002 aina tähän hetkeen voidaan noiden periaatteiden pohjalta esittää seuraavasti :	tulokset
Asetuksen N:o 19/65/ETY [MASK] on tarkistettu siten , että siinä otetaan huomioon Amsterdamin sopimuksen 12 artiklan mukainen Euroopan yhteisön perustamissopimuksen artiklojen uudelleennumerointi ; alun perin nimessä oli viittaus perustamissopimuksen 85 artiklan 3 kohtaan .	nimi
Asetuksen ( EY ) N:o 622/98 2 artiklan mukaisesti Bulgarian liittymistä valmistelevaan kumppanuuteen sisältyvät [MASK] , ensisijaiset tavoitteet , välitavoitteet ja edellytykset esitetään tämän päätöksen liitteessä , joka on erottamaton osa päätöstä .	periaatteet
Liittymistä valmistelevan kumppanuuden [MASK] valvotaan Eurooppa-sopimuksella perustetuissa elimissä ja asianomaisissa neuvoston elimissä , joille komissio raportoi säännöllisesti .	toteuttamista
Jäsenvaltioiden keskenään vaihtamat [MASK] on toimitettava myös komissiolle .	tiedot
( 2 ) Torjunta-aineiden jäämien [MASK] arvioidaan jatkuvasti uudelleen , ja niitä muutetaan uuden tietämyksen ja tutkimustulosten huomioon ottamiseksi .	enimmäismääriä
( 4 ) Kuluttajien elinikäistä ja lyhytaikaista [MASK] tämän direktiivin soveltamisalaan kuuluvalle fenamifossille elintarvikkeiden välityksellä on arvioitu yhteisössä käytettyjen menettelyjen ja käytänteiden mukaan ottaen samalla huomioon Maailman terveysjärjestön julkaisemat ohjeet ( 7 ) .	altistumista
( 5 ) Kuluttajien akuuttia [MASK] näille torjunta-aineille kaikkien sellaisten elintarvikkeiden välityksellä , jotka saattavat sisältää jäämiä , on tarvittaessa arvioitu yhteisössä käytettyjen menettelyjen ja käytänteiden mukaan ottaen samalla huomioon Maailman terveysjärjestön julkaisemat ohjeet .	altistumista
( 6 ) Yhteisön [MASK] on kuultu tässä direktiivissä esitetyistä jäämien enimmäismääristä Maailman kauppajärjestön välityksellä ja niiden näitä tasoja koskevat huomautukset on otettu huomioon .	kauppakumppaneita
( 7 ) Kasveja käsittelevän tiedekomitean [MASK] on otettu huomioon .	lausunnot
( 8 ) Direktiivien 86/362/ETY , 86/363/ETY ja 90/642/ETY [MASK] olisi tämän vuoksi muutettava vastaavasti .	liitteet
( 2 ) Päätöksen 1999/730/YUTP [MASK] jatkettiin ja päätöstä muutettiin viimeksi päätöksellä 2004/792/YUTP .	voimassaoloa
( 4 ) Päätöksen 1999/730/YUTP [MASK] olisi näin ollen jatkettava ja päätös olisi muutettava ,	voimassaoloa
( 2 ) Tämä yhteinen [MASK] otettiin käyttöön olemassa olevien kansainvälisten velvoitteiden mukaisesti ja erityisesti sellaisten velvoitteiden mukaisesti , jotka johtuvat tullitariffeja ja kauppaa koskevan yleissopimuksen , jäljempänä ` GATT-sopimus ` , VI artiklasta , GATT-sopimuksen VI artiklan täytäntöönpanoa koskevasta sopimuksesta ( vuoden 1979 polkumyyntikoodi ) sekä GATT-sopimuksen VI , XVI ja XXIII artiklan tulkintaa ja soveltamista koskevasta sopimuksesta ( vientituki- ja tasoitustullikoodi ) ;	järjestely
( 33 ) Sen lisäksi kyseistä [MASK] on muutettu kaksi kertaa ;	asetusta
( 34 ) Selvyyden , avoimuuden ja oikeusvarmuuden vuoksi kyseinen [MASK] olisi sen vuoksi kumottava ja korvattava , sanotun kuitenkaan rajoittamatta kyseisen asetuksen tai asetuksen ( ETY ) N:o 2423/88 nojalla jo aloitettujen polkumyyntimenettelyjen jatkamista ;	asetus
Jos viejä ei tuota tai myy samankaltaista tuotetta viejämaassa , [MASK] määritetään muiden myyjien tai tuottajien hintojen perusteella .	normaaliarvo
Sellaisten osapuolten , joiden välillä näyttää olevan yhtiösuhde tai hyvitysjärjestely , välisiä [MASK] ei voida pitää tavanomaisessa kaupankäynnissä sovellettuina ja niitä voidaan käyttää normaaliarvon määrittämisessä vain , jos vahvistetaan , että tällainen yhteys ei vaikuta hintoihin .	hintoja
3. Mikäli samankaltaista tuotetta ei myydä tavanomaisessa kaupankäynnissä tai myynti on riittämätöntä tai erityisestä markkinatilanteesta johtuen tällaisen myynnin perusteella ei voida tehdä asianmukaista vertailua , samankaltaisen tuotteen [MASK] lasketaan alkuperämaan tuotantokustannusten perusteella lisättynä kohtuullisella määrällä myynti- , hallinto- ja muita kustannuksia sekä voittoa , tai tavanomaisessa kaupankäynnissä soveltuvaan kolmanteen maahan käytettyjen vientihintojen perusteella edellyttäen , että hinnat ovat edustavia .	normaaliarvo
Kustannusten asianmukaista kohdentamista koskevat [MASK] otetaan huomioon , jos osoitetaan , että tämäntyyppistä kohdentamista on todellisesti käytetty .	todisteet
Kyseisenä tutkimusajanjaksona sovellettavien kustannusten oikaisujen osalta perustamisvaihetta koskevat , tutkimusajanjaksoa myöhempään ulottuvat [MASK] otetaan huomioon silloin , kun ne toimitetaan ennen tarkastuskäyntejä ja kolmen kuukauden kuluessa tutkimuksen vireillepanosta .	tiedot
Jos kyseisiä määriä ei näin voida määrittää , [MASK] voidaan määrittää käyttäen seuraavia perusteita : a ) muiden tutkimuksen kohteena olevien viejien ja tuottajien osalta vahvistettujen tosiasiallisten määrien painotettu keskiarvo samankaltaisen tuotteen tuotannossa ja myynnissä alkuperämaan kotimarkkinoilla b ) kyseisen viejän tai tuottajan maksamat tai saamat tosiasialliset määrät saman yleisen luokan tuotteiden tuotannossa ja myynnissä tavanomaisessa kaupankäynnissä alkuperämaan kotimarkkinoilla c ) mikä tahansa muu hyväksyttävä menetelmä sillä edellytyksellä , että siten määritetty voiton määrä ei ylitä voittoa , jonka muut viejät tai tuottajat tavallisesti saavat samaan yleiseen luokkaan kuuluvien tuotteiden myynnissä alkuperämaan kotimarkkinoilla .	ne
7. Muussa kuin markkinatalousmaista peräisin olevassa tuonnissa ja erityisesti sellaisista maista , joihin sovelletaan neuvoston asetusta ( EY ) N:o 519/94 ( 5 ) , peräisin olevassa tuonnissa [MASK] määritetään kolmannessa maassa , joka on markkinatalousmaa , käytettävän hinnan tai laskennallisen arvon perusteella tai sellaisesta kolmannesta maasta muihin maihin , myös yhteisöön , käytetyn hinnan perusteella taikka , jos tämä ei ole mahdollista , millä tahansa hyväksyttävällä perusteella , mukaan lukien samankaltaisesta tuotteesta tosiasiallisesti yhteisössä maksettu tai maksettava hinta , jota on tarvittaessa oikaistu kohtuullisella voittomarginaalilla .	normaaliarvo
9. Jos vientihintaa ei ole tai jos näyttää siltä , että vientihinta ei ole luotettava , koska viejän ja tuojan tai kolmannen osapuolen välillä on yhtiösuhde tai hyvitysjärjestely , [MASK] voidaan muodostaa sen hinnan perusteella , jolla maahantuodut tuotteet jälleenmyydään ensimmäisen kerran riippumattomalle ostajalle , tai jos tuotteita ei jälleenmyydä riippumattomalle ostajalle tai niitä ei jälleenmyydä samanlaisessa kunnossa , jossa ne olivat tuotaessa , millä tahansa muulla hyväksyttävällä perusteella .	vientihinta
1 ) Asetuksen ( ETY ) N:o 2377/90 mukaisesti jäämien [MASK] on vahvistettava asteittain kaikille farmakologisesti vaikuttaville aineille , joita käytetään yhteisössä elintarvikkeita tuottaville eläimille annettaviksi tarkoitetuissa eläinlääkkeissä .	enimmäismäärät
2 ) Jäämien [MASK] voidaan vahvistaa vasta , kun eläinlääkekomitea on tutkinut kaikki asiaan liittyvät tiedot kyseisen aineen jäämien turvalllisuudesta eläinperäisten elintarvikkeiden kuluttajalle ja niiden vaikutuksesta elintarvikkeiden teolliseen jalostukseen .	enimmäismäärät
4 ) Jäämien valvomiseksi yhteisön lainsäädännön mukaisesti jäämien [MASK] on yleensä vahvistettava kohdekudokselle , maksalle tai munuaisille .	enimmäismäärät
5 ) Munivalle siipikarjalle , maitoa tuottaville eläimille tai mehiläisille annettavaksi tarkoitettujen eläinlääkkeiden jäämien [MASK] olisi vahvistettava myös munille , maidolle ja hunajalle .	enimmäismäärät
6 ) Aloe vera [MASK] ja Aloe veran kokolehtiuute olisi lisättävä asetuksen ( ETY ) N:o 2377/90 liitteeseen II .	geeli
Asetuksen ( EY ) N:o 1265/2001 4 artiklassa tarkoitetun valkoisen sokerin [MASK] vahvistetaan 33,550 EUR/100 kg:ksi 1 päivän joulukuuta 2005 ja 31 päivän joulukuuta 2005 väliseksi ajaksi .	tuotantotuki
Asioissa , jotka kuuluvat Euroopan unionista tehdyn sopimuksen V ja VI osastoihin , EU:n [MASK] esittää neuvoston puheenjohtajana toimivan maan edustaja .	kannan
EU:n kantojen aukoton [MASK] varmistetaan .	johdonmukaisuus
2. Demokratian periaatteita , ihmisoikeuksia ja perusvapauksia koskevia [MASK] käsitellään niiden tärkeyden vuoksi assosiaatiosopimuksen olennaisina osina ja niistä keskustellaan asianmukaisesti assosiaatiosopimuksella perustetuissa elimissä .	kysymyksiä
1. Ihmisoikeuksia ja demokratiaa käsittelevän alakomitean toimeksiantoon sisältyviä [MASK] voidaan myös ottaa käsittelyyn korkeammalla tasolla osana EU:n ja Tunisian välistä poliittista vuoropuhelua .	asioita
Kaikki alakomiteaa koskevat [MASK] toimitetaan sihteereille .	tiedonannot
( 1 ) Rahalaitossektorin konsolidoidusta taseesta 1 päivänä joulukuuta 1998 annettua Euroopan keskuspankin [MASK] ( EY ) N:o 2819/98 ( EKP/1998/16 ) ( 3 ) on aiemmin muutettu asetuksella ( EY ) N:o 1921/2000 ( EKP/2000/8 ) ( 4 ) .	asetusta
( 10 ) [MASK] on vahvistettava viimeistään kunkin pitoajanjakson ensimmäisenä päivänä Euroopan keskuspankin ja luottolaitosten likviditeetin hallinnan helpottamiseksi .	Varantovelvoitteet
( 12 ) EKP:n rahataloudelliset [MASK] on saatu asetuksen ( EY ) N:o 2819/98 ( EKP/1998/16 ) mukaisesti kerätyistä rahalaitosten tasetilastoista , jotka määriteltiin talous- ja rahaliiton toisessa vaiheessa ja joita pidettiin vähimmäistietomääränä rahapolitiikan tarpeisiin .	tilastot
( 16 ) Taseeseen sisältynyt erillinen [MASK] " rahamarkkinapaperit " poistetaan ja sulautetaan luokkaan " liikkeeseen lasketut velkapaperit " vastattavaa-puolella ,	luokka
Tähän luokkaan kuuluneet [MASK] kirjataan liikkeeseen laskettuihin velkapapereihin ja ryhmitellään niiden alkuperäisen maturiteetin mukaan .	instrumentit
3. Tilastoinnissa käytettävä rahalaitosten [MASK] on laadittu ainoastaan tiedoksi .	luettelo
Eräitä tase-eriä koskevia [MASK] raportoidaan neljännesvuosittain kantatietoina .	lisätietoja
- niitä pieniä [MASK] , jotka eivät ole luottolaitoksia , koskevat suppeammat tiedonantovaatimukset , sellaisina kuin niistä on määrätty tämän asetuksen liitteessä III .	rahalaitoksia
Leivän lisäksi myös [MASK] ovat edustettuina TYY:n ja ÅAS:n järjestämän mäenlaskukilpailun muodossa .	sirkushuvit
” Vaan jonkunhan nekin [MASK] on tehtävä . ”	työt
Huippukokouksen tuloksena TiTeTan [MASK] laitettiin uusiksi : Turun vuoro koittaa seuraavan kerran vasta vuonna 2011 .	järjestysvuorot
Toiseen erään vaihtopelaajien [MASK] vähennettiin , ja tulostakin alkoi tulemaan .	määrää
Toimituksen nautittua lounaan läheisessä kuppilassa [MASK] jatkettiin Globate Oy:n toimesta .	seminaaria
Ehkäpä illan aikana joidenkin [MASK] lämmitti myös jokin muu kemikaali siivittäen kiertäjät lopulta kokeilemaan tanssijalkansa vipatusta Sykkesseen Kauppatorin laidalle .	ruumiita
Otsa hiessä pitää sinun [MASK] ansaitseman ?	leipäsi
Tai edes kuinka paljon uutta [MASK] hän on kurssilla oppinut ?	asiaa
Liiallisesta omistautumisesta alalleen ei [MASK] voida syyttää .	naistutkijoita
Tätä lauluihin koodattua [MASK] kutsutaan nimellä Songlines .	maailmanjärjestystä
Kuinka kaiken aikaa [MASK] , hahmottoman ja virtaavan voi asettaa pysyväksi tarkoitettuun systeemiin , ihmisten maailmankaikkeuteen ?	muuttuvan
Jotta kaaos ei pääsisi murtautumaan kosmokseen tuhovoimaisena , [MASK] käsitellään rituaalien avulla .	sitä
Vaikka esimerkki on otettu alkuperäiskansojen uskonnollisuudesta , on erilaisia [MASK] tietysti löydettävissä muistakin kulttuureista , myös modernista länsimaalaisesta kulttuurista .	siirtymäriittejä
Monet nykyajan “ [MASK] ” kuten intomieliset vegaanit tai talvisotaa lähipubissa hehkuttavat suomileijonat voidaan ymmärtää tältä pohjalta : ne tarjoavat jäsenilleen jonkinlaisen tunnustetun identiteetin .	heimot
Jääkaapin yläpuolella sijaitseva pakastin on [MASK] ansainnut .	lempinimensä
Ruotsalaisen Dagens Nyheterin tietojen ja kuvien mukaan [MASK] on samalla tavalla sisustettu kuin Ikean tavaratalot , esillepano muistuttaa Ikeaa , keltasininen väritys on sama ja jopa ostoslistan tekemiseen tarkoitetut pienet lyijykynät on kopioitu Ikealta .	myymälä
Ekstaasin käytön myönteisiä [MASK] , kuten lisääntynyttä empatiakykyä , energisyyttä ja euforiantunnetta ei ole tutkittu juuri lainkaan .	vaikutuksia
Myönteisen käytöksen laukaisevia neurologisia [MASK] seurataan magneettikuvauksin .	tekijöitä
Kolmen A:n valtioiden [MASK] pidetään vakaina ja niiden velkakirjoja turvallisina .	hallintoa
Kun ongelmat kielletään , [MASK] ei myöskään voi korjata .	niitä
Kahtiajaon yhteiskunnassa tätä [MASK] käydään liian vähän .	keskustelua
Tämän räjähdyksen välttämiseksi [MASK] esimerkiksi maahanmuutosta pitäisi lisätä eikä vähentää .	keskustelua
Valion mukaan myöskään [MASK] ei ole käytetty viiteen vuoteen .	Onni-tavaramerkkiä
Tutkimusyhtiö Canalysin mukaan Android-käyttöjärjestelmällä varustettuja [MASK] myydään selkeästi muita enemmän .	älypuhelimia
Toisella neljänneksellä Microsoft-pohjaisia [MASK] myytiin 1,5 miljoonaa kappaletta , 52 prosenttia vähemmän kuin viime vuoden huhti-kesäkuussa .	laitteita
Kivenä kengässä olleet [MASK] ratkaistiin pääosin siirtämällä kysymykset työryhmien ratkaistavaksi .	tekstikysymykset
Ensi vuonna lennonjohtajien [MASK] korotetaan 1. elokuuta alkaen 2,8 prosentin suuruisella yleiskorotuksella .	palkkoja
Vuotta aiempaan verrattuna uusia [MASK] rekisteröitiin 17,6 prosenttia enemmän .	ajoneuvoja
Finavian mukaan kaikki [MASK] voidaan lentää , vaikka lennonjohtajat aloittaisivatkin lakkonsa .	lennot
Brittiläisen Telegraph-sanomalehden johtavan poliittisen kommentaattorin Peter Obornen mukaan euromaiden päätöksen [MASK] ei voi korostaa liikaa .	merkityksellisyyttä
Ksylitolin hammasterveyteen vaikuttavat [MASK] todettiin 1970-luvulla professori Arje Scheininin ja Kauko Mäkisen johdolla Turun yliopistossa tehdyissä tutkimuksissa : kun muut makeutusaineet lisäsivät hammaskariesta , ksylitoli osoittautui kariesta ehkäiseväksi .	ominaisuudet
Kokovuotisen työskentelyn mahdollistavia , 21 000 euron [MASK] myönnettiin viisi ja puolivuotisia apurahoja 26 .	apurahoja
Biodiversiteetin merkitys -hankehaussa [MASK] myönnettiin kaikkiaan kuudelle tutkimusprojektille ja yhdelle digitointihankkeelle .	tukea
Turun yliopiston entinen kansleri [MASK] Vuorio on palkittu Turun Yliopiston perustamisen suurella muistomitalilla .	Eero
Turun Yliopiston perustamisen suuri [MASK] luovutettiin Turun Yliopistosäätiön valtuuskunnan kevätkokouksessa , joka samalla myönsi Vuoriolle hänen pyytämänsä eron Turun Yliopistosäätiön hallituksesta .	muistomitali
Turun Yliopiston perustamisen suuri [MASK] lyötettiin vuonna 1922 Turun Yliopiston avajaisten muistoksi .	muistomitali
10 000 euron suuruinen [MASK] jaettiin 22.4. Duodecimin Opetuksen kehittämisseminaarin yhteydessä Espoossa .	palkinto
Tällä hetkellä esimerkiksi [MASK] hyödynnetään alueen yrityksissä heikosti .	EU-rahoitusta
Hakijoiden määrän runsasta [MASK] selittää osaltaan se , että luvussa on mukana ensimmäistä kertaa Turun kauppakorkeakouluun hakeneet .	kasvua
Onko lääkekehityksellä tulevaisuutta Suomessa ? -symposiumin ensimmäisen [MASK] käytti emeritusprofessori Risto Santti .	puheenvuoron
Konsortiossa rakennettu kliinisen suomen kielen [MASK] on havaittu toimivaksi koekäytössä TYKSin lastenklinikalla .	työkalupaketti
Monitieteisessä yhteistyössä lingvististä [MASK] edustaa mm. ranskan kielen tutkija Veronika Laippala .	näkökulmaa
Vuonna 2008 Turun yliopistossa käynnistynyt Lasten [MASK] on tarkoitettu 7−10-vuotiaille koululaisille .	yliopisto
Suomen Akatemian lukiolaisille järjestämän vuoden 2009 Viksu-tiedekilpailun kansainvälisen sarjan 4000 euron suuruisen [MASK] voitti Salli Anttila Turun normaalikoulusta fysiikan alan työllään .	ykköspalkinnon
Viksu-tiedekilpailun kansallisen sarjan [MASK] voittivat Savonlinnan lyseon oppilaat Eveliina Tahvanainen ja Siniriikka Ventelä psykologian alan parityöllä , joka koski anoreksiaa .	ykköspalkinnon
Venäjän talouden modernisoitumisesta puhuttaessa ei palvelualojen [MASK] voidakaan Anttosen mukaan korostaa liikaa .	merkitystä
- Kun olemme EU-oikeuden piirissä , pitää näitä [MASK] toteuttaa myös kansallisella tasolla , Rosas sanoi .	lakeja
Turun yliopiston Merenkulkualan koulutus- ja tutkimuskeskuksen toteuttama Etelä-Suomen logistiikka-alan [MASK] julkaistiin 31. maaliskuuta .	suhdannebarometri
Vähentyneen kysynnän lisäksi logistiikkayritysten [MASK] ovat viimeisen vuoden aikana supistaneet alentuneet logistiikkapalvelujen hinnat .	liikevaihtoa
Hännisen mukaan yliluonnollisten kokemusten poikkeavasta luonteesta huolimatta , niiden [MASK] voidaan esittää tavalla , jolla henkilö kokee itsensä osaksi yhteiskuntaa ja normeja noudattavaksi yksilöksi .	kokeminen
Turun ammattikorkeakoulussa rakennustekniikan yliopettajana toimivan Jouko Lehtosen mukaan [MASK] projektitöistä oli tehty asiakkaille ja osa virtuaalihankkeina .	osa
Myös esimerkiksi avioliiton vaikutuksia puolison sukunimeen , lasten huoltoa ja kansalaisuuden saamisen ehtoja koskevat [MASK] uudistettiin sukupuolineutraaleiksi .	säännökset
Kiinan mukaan ensimmäiset kiinalaiset [MASK] saarista tehtiin vuonna 1403 , ja saaria on hallittu vuosisatoja Taiwanin osana .	tutkimukset
Kappaleen suomenkieliseen versioon [MASK] teki Saukki .	sanat
Alkuaikoina lähes kaikki moottoripyörien [MASK] valmistettiin KTM:n omassa tehtaassa .	osat
Työskenneltyään muutaman vuoden Ignatiuksen alaisena Italiassa [MASK] lähetettiin synnyinmaahansa Portugaliin .	Rodrigues
Koska kirjeet eivät tehonneet , [MASK] kutsuttiin Roomaan ja omasta halustaan asetettiin tuomittavaksi .	Rodrigues
Tosiasiallisessa julkisen vallan käytössä [MASK] ei sen sijaan muuteta van toteutetaan jokin käytännön toimi , esimerkiksi häirikön poistaminen julkisesta sisätilasta .	oikeussuhteita
Vähäisiä julkisen vallan [MASK] on delegoitu lailla myös yksityisille kansalaisille ( esimerkiksi kalastuksenvalvojat ) , julkisomisteisille liikelaitoksille ja yksityisille yhteisöille ( esimerkiksi yksityiset perusopetuksen antajat ) .	käyttömahdollisuuksia
Amerikan ja Euroopan [MASK] julkaistiin 7. maaliskuuta , 2006 ilman DVD:tä .	versio
" Machine Gun " [MASK] seurasi cover-raita Elvis Presleyn kappaleesta " That's Alright , Mama " .	-kappaletta
400 metrin juoksun [MASK] hän voitti 1995 .	mestaruuden
Latinan kieliopissa nominien [MASK] kutsutaan deklinaatioiksi ja verbien taivutusluokkia konjugaatioiksi .	taivutusluokkia
Albumin kappaleista muun muassa " [MASK] It " soitettiin Smallvillen 5. tuotantokaudella ja pääsi myös kyseisen sarjan levylle .	Forget
Vimin keskeinen idea on , että ei kumpaakaan [MASK] tarvitse siirtää näppäimistöltä ( esimerkiksi hiirelle ) minkään toiminnon , kuten tallentamisen , ajaksi .	kättä
Myös yhden kunnan kautta keskuskuntaan vähintään 10 prosentin osuudella pendelöivät [MASK] luetaan työssäkäynti-alueeseen kuuluviksi .	kunnat
Toisen maailmansodan lopussa [MASK] ylennettiin koko Saksan armeijan XXI armeijakunnan ylipäälliköksi .	hänet
Erityisesti toisen maailmansodan aikana [MASK] käytettiin runsaasti .	keinoa
Myös muualla maailmassa [MASK] käytettiin paljon ; amerikkalaiset asensivat niitä hävittäjiin ja saattuehävittäjiin , koska savuverho oli tehokas keino eritoten tutkattomia tai enintään heikkotasoisen tutkan omaavia japanilaisia sotalaivoja vastaan .	savugeneraattoria
Näitä niin sanottuja konsekutiivisia [MASK] käytetään lähinnä Raamatun hepreassa .	aikamuotoja
Ensimmäisen maailmansodan jälkeen , Itävalta-Unkarin hajottua , [MASK] nimettiin virallisesti Novo mestoksi , jolla nimellä se oli tunnettu epävirallisesti perustamisestaan lähtien .	kaupunki
* 1920 – Ensimmäinen Kansainliiton [MASK] pidettiin Genevessä .	yleiskokous
* 1983 – Pohjois-Kyproksen turkkilainen [MASK] perustettiin .	tasavalta
Jo tuohon aikaan Kiinan [MASK] olivat jaettuna kahden sotapäällikön hallintaan ( myöhemmin Shu Han -kuningaskunta ja Wu-kuningaskunta ) .	eteläosat
Lähes kaikkia KISSin alkuperäiskokoonpanon alun perin nauhoittamia [MASK] on muuteltu ja päivitetty .	kappaleita
" Bethin " [MASK] nauhoitettiin kokonaan uusiksi - alkuperäisen rumpalin Peter Crissin vokaalit korvasi silloinen kannuttaja Eric Carr .	lauluosuudet
Aiemmin myös mm. osuusmeijereiden ja tehtaiden [MASK] , " isännän sijaista " , kutsuttiin isännöitsijäksi , nykyään heidän ammattinimityksensä on toimitusjohtaja .	johtajaa
Harvoin nämä kaksi toisistaan täysin erillistä [MASK] sekoitetaan keskenään .	tutkintoa
Varhaiskeskiaikaisen georgialaisen perinteen mukaan ensimmäisen [MASK] Mirian III:n ( hallitsi 284–361 ) nosti Iberian valtaistuimelle hänen isänsä , johon kronikat viittaavat nimellä " Khosroes " , Iranin suuri kuningas .	khosroidikuninkaan
Suvun kaksi muuta [MASK] asetettiin pian Gogarenen ja Gardmanin valtaistuimille : ne olivat kaksi Kaukasian alueen ruhtinaskuntaa , joissa kolme kansallisuutta , armenialaiset , albanialaiset ja georgialaiset , elivät yhdessä .	haaraa
Nisibiksen rauhassa vuonna 298 Rooman [MASK] Itä-Georgiassa kuitenkin vahvistettiin , mutta Rooma tunnusti tästä huolimatta Mirianin Iberian kuninkaaksi .	ylivalta
Toisen maailmansodan lähestyessä ja jo osittain riehuessa , [MASK] nimitettiin everstiksi 19. syyskuuta 1939 .	Kaarle
Näissä esimerkiksi ‘ [MASK] ’ saadaan ‘ A ’ -näppäimesta ja ‘ Б ’ ‘ B ’ -näppäimestä .	А
Vasempana laitahyökkääjänä pelannut [MASK] varattiin numerolla 10 New York Rangersiin vuoden 1971 varaustilaisuudessa .	Vickers
* 1690 – [MASK] keksittiin Nürnbergissä .	Klarinetti
* 1996 – [MASK] Sampaio valittiin Portugalin presidentiksi .	Jorge
* 2004 – Georgian [MASK] , ns. " viiden ristin lippu " , otettiin uudelleen käyttöön noin 500 vuoden tauon jälkeen .	kansallislippu
Jossain kulttuureissa ehdollista [MASK] kutsutaan lykätyksi rangaistukseksi .	rangaistusta
Enintään kahden vuoden [MASK] voidaan määrätä ehdolliseksi , jos ei rikoksen vakavuus , rikoksesta ilmenevä tekijän syyllisyys tai tekijän aikaisempi rikollisuus edellytä ehdottomaan vankeuteen tuomitsemista .	vankeusrangaistus
Rikoksen alle 21-vuotiaana [MASK] voidaan tuomita ehdollisen vankeuden tehosteeksi koeajaksi valvontaan , jos tätä on pidettävä perusteltuna tekijän sosiaalisen selviytymisen edistämiseksi sekä uusien rikosten ehkäisemiseksi .	tehnyt
Myös tieliikennerikokseen liittyvä [MASK] voidaan tietyillä edellytyksillä määrätä ehdollisena .	ajokielto
Myös joitain nopeakasvuisia [MASK] , kuten montereynmäntyä ( Pinus Radiata ) voidaan käyttää hiokkeen valmistuksessa .	mäntylajikkeita
Von Sydowin myöhemmän [MASK] pohjusti pääsy Bergmanin ympärilleen keräämään kiinteään työryhmään , jonka muita näyttelijäjäseniä olivat muun muassa Gunnar Björnstrand , Erland Josephson , Ingrid Thulin , Harriet Andersson ja Bibi Andersson .	maineen
50 kilometrin korkeudessa [MASK] irrotettiin ja loppuosa laskeutumisesta tapahtui kaasukehän kitkan aiheuttaman jarrutuksen avulla .	laskuvarjo
Vaikka Te Rauparaha ei ollut tapahtumaan suoraan osallinen [MASK] pidätettiin kuvernööri George Greyn toimesta ja karkoitettiin Pohjoissaarelle .	hänet
Vuoden 1989 lopussa [MASK] osti Jean-Pierre van Rossem , joka kuitenkin myi sen vuoden 1990 alussa Peter Monteverdille .	tallin
Kaavion ulkopuolelta tuleva [MASK] voidaan merkitä lähteväksi mustatusta ympyrästä .	viesti
Tapahtuman vähemmän raskasta [MASK] esitti oululainen , raskasta rockia soittava Ristinolla .	antia
Kauden 2006–07 päätteeksi [MASK] valittiin NHL:n kakkostähdistöön .	hänet
Rataosan Kontiomäki–Vartius sähköistys- ja turvalaitetöiden yhteydessä Ypykkävaaran [MASK] muutettiin junakohtauspaikaksi , ja uusi liikenteenohjauslaitteisto otettiin käyttöön 24. elokuuta 2006 .	liikennepaikka
Sittemmin Sturmgeist-tunnuksella esiintyneen käyttäjän [MASK] on suljettu , eikä videoita ole enää nähtävillä .	YouTube-tunnus
Našin oletetun mielenosoituksen [MASK] aikoo järjestää Kai Pöntinen Sanomatalossa .	vastamielenosoituksen
Muissa Euroopan maissa [MASK] on julkaistu .	uutinen
Joukkoraiskauksen uhriksi joutunut [MASK] vangittiin	saudinainen
Joukkoraiskauksen uhriksi joutunut 19-vuotias [MASK] tuomittiin kuuden kuukauden vankeusrangaistukseen Saudi-Arabiassa .	nainen
Jatkosodan alkamisen jälkeen [MASK] melko pian ylennettiin vääpeliksi ja tuolloin hän toimi partionjohtajana osasto Kuismasessa .	hänet
Vapaudenristin 2. luokan [MASK] myönnettiin yhteensä 191 miehelle , joista neljälle risti annettiin kahdesti .	Mannerheim-risti
Roolipeli- ja animetapahtuma [MASK] IV järjestetään lauantaina 7. helmikuuta kello 10–19 Tampereen teknillisellä yliopistolla .	Tracon
Neste Oil ei tätä [MASK] tehnyt .	ilmoitusta
Gorbatšovin mukaan Yhdysvaltain suunnittelemat [MASK] Euroopassa on " korvamerkitty " Venäjää vastaan .	ohjukset
Albert Edelfeltin maalaus [MASK] l'Artiste myytiin eurooppalaiselle taidekauppiaalle 413 000 euron hinnasta New Yorkin taidehuutokaupassa tiistaina .	Chez
Selvityksen mukaan kasvihuonepäästöjen [MASK] on laskettava 50 %:lla vuoden 1990 tasosta vuoteen 2050 mennessä .	määrää
Yhden sivun pituinen [MASK] allekirjoittajineen on luettavissa sivulla http://www.climate.unsw.edu.au/bali/	selvitys
US Shipbrokersin mukaan [MASK] on myyty noin 9,85 miljoonalla dollarilla eli 6,5 miljoonalla eurolla romutettavaksi .	Finnjet
Herlinien teollisuussukuun kuuluva 26-vuotias [MASK] Nurminen siepattiin kotoaan 27. toukokuuta 2009 ja vapautettiin 13. kesäkuuta .	Minna
Majuri Sami Aarnion mukaan [MASK] ei ollut varsinaisesti kutsuttu , vaan hän itse oli puolisen vuotta aikaisemmin ollut yhteydessä Puolustusvoimiin , mutta mitään tehtäviä hänelle ei ollut osoitettu .	Mikkosta
Yhdeksän päivän päästä tapahtuvaa [MASK] on valmisteltu ja rakennettu 20 vuoden ajan kansainvälisin voimin .	koetta
Vuosi sitten Suodenniemen [MASK] liitettiin osaksi Vammalan kaupunkia .	kunta
* 13. lokakuuta 2009 : [MASK] käytetty laittomaan SDP:n rahoittamiseen	Urheiluopistosäätiötä
* 10. heinäkuuta 2009 : Ruotsidemokraattien [MASK] pahoinpideltiin	lehdistösihteeri
* 28. kesäkuuta 2009 : [MASK] Arhinmäki valittiin Vasemmistoliiton puheenjohtajaksi	Paavo
* 11. kesäkuuta 2009 : Kielipoliittinen toimintaohjelma Suomen kielen [MASK] julkistettu	tulevaisuus
* 19. toukokuuta 2009 : [MASK] Repoa uhkaa erottaminen kirkosta	Mitro
Synnytyksessä mukana ollutta [MASK] avusti satelliittipuhelimen välityksellä synnytyslääkäri sekä lennolla olleet kaksi sairaanhoitajaa ja lääkäri .	lentohenkilökuntaa
Tässä Yhdysvaltain eräässä asukasluvultaan pienimmässä osavaltiossa [MASK] järjestetään tulevana tiistaina .	esivaalit
Kyllä se voisi [MASK] ja paskaset kalsarinsa muuallakin pesettää kuin sinulla .	paitansa
Jan Bataldenin mielestä keskieurooppalaista elintarvikekaupoissa harjoitettavaa vapaata [MASK] ei voi ajatella Norjassa .	alkoholinmyyntiä
Miten sellainen voi [MASK] auttaa .	ketään
Kantapään kautta opitut [MASK] muistetaan kaikkein parhaiten .	asiat
Varsinkin Meta kakkosesta käsin katsottuna [MASK] määrittää jatkuva puute .	valtavirtakirjallisuutta
Ei valmentaja yksin voi jokaiselle pelaajalle jokaista [MASK] opettaa ja sanoa .	asiaa
kyllä niiltä aina [MASK] saa kuinka päin tahansa kunhan vain toisin pari pulloa prenkkua .	maksun
Tiskaamallakos herra sitten [MASK] maksaa ?	juomansa
Jotakuinkin kelvollista suomenkielistä [MASK] on kirjoitettu vasta noin 130 vuotta .	kirjallisuutta
Paitsi Pohjois-Amerikassa , [MASK] käytetään virsisävelmänä ainakin Isossa-Britanniassa .	Finlandiaa
Toistaiseksi osuvinta ja ammattitaitoisinta [MASK] ovat kumma kyllä tarjonneet harrastajat .	musiikkiteatteria
Saksassa kamarimusiikin professuuria hallussaan pitävä [MASK] tunnetaan Euroopassa , Heinonen on taas esiintynyt Suomen ulkopuolella pääasiassa Pohjoismaissa .	Gothoni
Jos kortti katoaa tai varastetaan , sen kaikki [MASK] voidaan kuolettaa heti .	toiminnot
Jos siirtorahat häviävät , [MASK] on saatava tilalle .	jotain
Ja homma olis se että ne [MASK] pitäs kantaa sinne lavalle .	seinänjätteet
Että sä et vaan jotakin [MASK] siirrä sen takia , että joku on käskenyt ...	nippeliä
Edellisen maajoukkuekomennuksen aikaan [MASK] luotsasi Pentti Matikainen .	Leijonia
Jos tapaus menee lain piiriin , [MASK] ei voida kirjoittaa , vaan asia siirtyy tuomioistuinkäsittelyyn .	sakkoa
ne oli laittomii [MASK] kähminy itsellee käyttäny sitä herkkäuskosta äijää hyväksee .	etuja
Ominaisuuksiinsa nähden edullinen [MASK] kytketään ohjelmalähteen ja erillisten päätevahvistimien väliin .	laite
Hallinnollis-taloudellisen ammattikokemukseni perusteella [MASK] varmaankin kutsuttiin johtokuntaan .	minut
Mutta täysin ehdottomasti hän ei mahdollista [MASK] tyrmää .	ehdokkuuttaan
- Tuolla tavallako sinä isäsi [MASK] kohtelet ?	vieraita
Tänä vuonna ei rannan [MASK] ole kuitenkaan siivottu , vaikka si ei mikään iso työ olisi .	pohjoisosaa
Heti kun laulan hieman rokimpaa niin [MASK] kuulee .	sen
Joulukuussa 1992 Backleyn [MASK] leikattiin , mutta olkapäävaiva ei ottanut hellittääkseen .	olkapää
Eikö sinulle ole [MASK] opetettu ?	tapoja
Jostain syystä minun [MASK] on siivottu .	pöytäni
Tasavallan presidentin lehdistöpäällikkö Maria Romantschukin mukaan [MASK] järjestettiin Mäntyniemessä iltapäivällä .	siviilivihkiminen
Sun takias minä [MASK] puhun , en minä muuten .	tätä
Meillä päin ei [MASK] vastusteta .	virkavaltaa
vankilasta käsin tapahtuvaa [MASK] ehkäistään antamalla vankilaviranomaisille enemmän valtuuksia .	rikollisuutta
Vaikeasti kehitysvammaisten lasten [MASK] aloitetaan 6-vuotiaana .	opetus
Ja ainahan tilatun [MASK] voi peruuttaa , siis asiakas .	työn
Sittemmin on urheilun [MASK] edelleen supistettu ja taiteen ja tieteen ja nuorisokasvatuksen lisätty	osuutta
Ja kyllä me [MASK] pistelemmekin .	niitä
olen näitä yksiä ja samoja [MASK] tehnyt koko elämäni .	tehtäviä
Myytiinpä Tampella Power tai ei , [MASK] on saatava kannattavaksi	se
Vastaavasti viisi seuraavaa [MASK] voidaan nykyisin ennustaa yhtä varmasti .	vuorokautta
ja sit miul [MASK] lie pantii korvii	mitä
Jos hän olisi ollut varaton , tokko [MASK] olisi otettu minnekään .	häntä
Budjetissa kirjastolle esitettyä [MASK] ei ole pidetty alkuunkaan riittävänä .	määrärahaa
mi olen ollu noip [MASK] kaatamas mettäs .	puita
tuota monille epämieluisaa [MASK] voi vältellä .	tointa
eihän ne ni [MASK] juovuksiij juonnu .	ihtiisäj
Eipä meillä kauaa ole [MASK] käytettykään .	alppimajoja
Tänä vuonna ei rannan [MASK] ole kuitenkaan siivottu , vaikka ei se mikään iso työ olisi .	pohjoisosaa
Tänä vuonna ei rannan [MASK] ole kuitenkaan siivottu , vaikk ei se mikään iso työ olisi .	pohjoisosaa
Alkuaan kuvankaunis yhteiskoulun [MASK] on tärvätty uudisrakentamisella .	rakennus
Wigwamin esikoisalbumin yhteen niitatut [MASK] mieleen tuovasti	pahvit
Ilkka Suomisen , 58 , pääjohtama [MASK] pidettäneen pystyssä siirtymäkauden ajan .	emoyhtiö
Voi tässä vielä joutua [MASK] pyytämään .	lisäaikaa
Uteliaitten paikallisten ihmisten ohella myös [MASK] oli hälytetty paikalle .	poliisi
Vajaa tunti aikaisemmin [MASK] tapasi teatterin keittiöstä muotoilemasta kookospalloja .	Nordinin
Janne Palokankaan mukaan [MASK] on pitänyt suorastaan toppuutella aloittamasta treenisesonkia liian kovalla höyryllä .	Mikaa
Anja ja Anetshka [MASK] keksimässä	pyörää
Vielä tässä vaiheessa kansalaisten [MASK] ohjaa pääsääntöisesti toivo päästä mukaan perinteisiin elämäntapakuvioihin .	tekemisiä
Siitä huolimatta yksi Kokos-tehtaan [MASK] on jätetty auki kenen tahansa kulkea sisään tai ulos .	ovista
Minä en ole [MASK] sanonut , eikä kukaan ole sitä sanonut kuulteni .	sitä
Useita meidän järjestämiämme [MASK] on viime aikoina moitittu liian rohkeiksi .	tilaisuuksia
Prosenteissa mitattuna tosi rajuja [MASK] , Kalliomäki päivittelee	leikkauksia
Monet PAH-aineet ovat [MASK] aiheuttavia .	syöpää
Kaikki puheenvuorot olivat [MASK] tukevia .	Kantolaa
Lähtiessä kun näitä [MASK] ei kysytä .	papereita
Jälkiruokaan ehdittyä ikävät [MASK] unohdettiin .	asiat
Jokainen kilpailun toiseen vaiheeseen valittu [MASK] palkitaan 2000 eurolla ideakilpailun tultua ratkaistuksi .	luonnosidea
Kaikki kolme Suomen [MASK] näytetään televisiossa .	kotiottelua
August Mellinin Lahteen 1890 valmistunut komea [MASK] raivattiin Alvar Aallon kirkon tieltä 1977 .	hirsikirkko
Esimerkiksi yliopistomaailmassa erilaisia tieteellisiä [MASK] jaetaan jo nyt verkon kautta .	julkaisuja
Manse PP:n miesten vuoden visiitti pääsarjassa ei paljon [MASK] tuonut .	lohtua
Äänekosken kaupungin ja Äänekosken ammatillisen koulutuksen kuntayhtymän neljä vuotta sitten käynnistämä teknillisen oppilaitoksen [MASK] on haudattu kaikessa hiljaisuudessa .	perustamishanke
Nuoren polven diiva [MASK] Larivaaraa ylistettiin .	Merja
tuskin se sillä sen [MASK] tarkoitti .	kummempaa
Entä jos sama [MASK] olisi sattumoisin tehty vasta vähän myöhemmin ?	keksintö
Mutta vaikka pikkulilli oli poissa , [MASK] särki kamalasti .	sitä
Tämä luhistumaisillaan ja hajallaan oleva [MASK] on järjestettävä uudelleen .	valtio
Viikon kuluttua oli [MASK] jo peloteltu luopumaan suunnitelmasta .	järjestöväki
Ihmisten vaatimuksista johtuen [MASK] kasvatetaan jo lähes yhtä rasvattomiksi kuin naudat .	siat
Ammatiksi asti Timo ei ole [MASK] kuitenkaan kaavaillut .	multimedia-alaa
Kaikki eivät uutta [MASK] usko .	tutkimustulosta
Joltakin Le Corbusierilta [MASK] ei missään tapauksessa odottaisi .	vastaavaa
Jos minä menisin kysymään joltakin naiselta Espan puistossa , syökö tämä makkaratuotteita usein ja minkä ikäinen hän on , [MASK] vietäisiin mustamaijaan .	minut
Ei valmentaja yksin voi kaikille pelaajille kaikkia [MASK] opettaa ja sanoa .	asioita
Jokunen vuosi sitten [MASK] Oy fuusioitiin Metsä-Botniaan .	Kemi
Don Carlon ja Marian [MASK] juhlittiin ruhtinaallisesti usean päivän ajan .	häitä
Emme olisi montaa tuhatta [MASK] tarvinneet .	markkaa
Länsimaisen superegon eli ylikorostuneen itsen [MASK] on parannettava .	mammuttitauti
Tusinasta kalliimpia ja kourallisesta kaikkein hienoimpia aitioita on jo kaikki [MASK] tehty	kaupat
Hanhilahden mukaan muissa EU-maissa [MASK] evätään vuosittain kahdesta viiteen prosentilta hakijoista .	tukia
vapaille ja demokraattisille vaaleille otolliset [MASK] voidaan luoda kahdesta kolmeen kuukaudessa .	olosuhteet
Liikkeissä olleet 40 [MASK] irtisanottiin maanantaina .	työntekijää
Jo Turun keskustan puoli viiden ruuhkassa [MASK] valtaa lähes kosminen ihmetys ja kauhu .	mielemme
- Kai te [MASK] huomaatte .	sen
Sen kun vaan [MASK] puolestani , Päivi hymähti .	minun
Kai ne olivat joskus [MASK] toisiaan kohtaan tunteneet , koskapa olivat menneet naimisiin .	jotain
sit ku me tultii ni sit [MASK] laulatti	meitä
Uusien rataosien rakentamisessa ja vastaavasti supistamisessa [MASK] olisi annettava eduskunnalle .	päätösvalta
kouluttamalla kehitysmaiden väestöä , varsinkin naisia , [MASK] voidaan ratkaista .	ongelmia
Niin vaikea kuin tämä asia onkin , [MASK] on saatava päätökseen tämän päivän aikana .	se
Näin esimerkiksi Sairaanhoitajaliiton [MASK] , joka nimenomaan ei halua olla Tehyn osaston jäsen , lasketaan Tehyn jäsenmäärään mukaan .	jäsen
Homman lähtökohta kuules on se , että [MASK] voi tehdä kolmella tavalla .	puuveneitä
Kovin korkeallepa sinä [MASK] arvostat	häntä
Kyllä minä kauniisti [MASK] kestän .	laulamista
Mitä sitä hauskaa [MASK] lykkäämään .	asiaa
Maaseudulta kaupunkiin muuttavia [MASK] odottaa välittäjiä jo linja-autoasemalla .	pikkutyttöjä
Varmuuden vuoksi ulkoasiainministeriön oikeudellinen [MASK] pantiin kirjoittamaan muistio , jossa --	osasto
Arabiankielisen tekstin kauniit kirjaimet ovat sellaisenaan [MASK] hiveleviä .	silmää
Kaupungissa hän ei [MASK] tarvitse , mutta mökillä Päijänteen takana ei ole tänä kesänä tullut käydyksi .	autoa
Jos markkinat kasvavat kohtuullista vauhtia , [MASK] voidaan pudottaa .	hintaa
Mut kato mä oon sitä [MASK] ajatellu ,	aikidoo
Vapaa-ajan pienet ja suuret [MASK] turvaat parhaiten - ja myös edullisimmin - Järjestön Tapaturmavakuutuksella .	haaverit
kun menin jääkaapille katsomaan , vieläkö sen valo toimii ( ja miks ei toimisi , uusi kaappi ) , niin [MASK] oli varastettu !	maito
Emme me voi [MASK] sinulle kertoa , täytyyhän sinun se ymmärtää , rakas lapsi .	sitä
Vertailumenestys ei minun auton [MASK] ratkaisisi , mutta onhan asiantuntijankin mielipide hyvä tietää .	valintaani
Ja mistä hänelle tiukkaa [MASK] edes löydettäisiinkään .	seuraajaa
Meitä tämän päivän [MASK] hemmotellaan satojen vaihtoehtojen tuotevalikoimalla .	jäätelöfaneja
Jos Nikkola oli tasainen , [MASK] vaivasi epävarmuus	Ahosta
Sitä vastoin uusia [MASK] ei rekisteröity ainuttakaan .	Porscheja
Suomen Pankissa ei kukaan [MASK] muuttanut , paitsi kun meni naimisiin .	nimeään
Jos ei sellaista ole , [MASK] pitää perustaa .	se
Joll ei väestökasvua saada kymmenen vuoden kuluessa hallintaan on [MASK] ylikansoitusta vastaan kenties lopullisesti hävitty .	taistelu
Tarkoitus on , että [MASK] hyväksytään kansanäänestyksessä lokakuun aikana , jolloin presidentinvaali ehdittäisiin pitää vielä ennen joulua .	lakiluonnos
aiemmin päätoimisesti opiskelleen henkilön [MASK] katsotaan päätoimiseksi siihen asti , kun hän on päättänyt opintonsa tai todistettavasti keskeyttänyt ne .	opiskelu
Samanlaisia vaikka pienempiä [MASK] " demokratian puolesta " pidettiin kaikissa Argentiinan suurissa kaupungeissa	mielenosoituksia
Niin huvittavalta kuin se kuulostaakin , [MASK] voi totuttaa käyttämään korvatulppia .	koiran
Oli tietokone miten pieni tai tehokas hyvänsä , [MASK] tekee aina ihminen .	työn
Teetpä minkälaisen altaan tai suihkulähteen tahansa , [MASK] voidaan aina muuttaa hyvällä valaistuksella .	sitä
Oli niin tai näin , niin [MASK] on kuitenkin menetetty .	jotain
Syksyn kuumin kysymys on hänen mielestään , miten [MASK] saadaan tasapainoon .	talous
Tavallinen virhe , mikä tehdään , on että [MASK] erotetaan vanhemmistaan .	lapset
ja sitten hallituksen [MASK] annetaan kenelle annetaan .	muodostamisprosessi
Säynätsalon ja Noormarkun [MASK] suunnitteli Armas Lindgren , Mäntän W.G.Palmqvist .	kirkot
Jos museon jälkeen vielä jaksaa , [MASK] voi ostaa kävellessään ostoskatu Via Romaa pitkin kohti keskustaa .	tuliaiset
Tässä elokuvassa oli joku [MASK] ammuttu haulikolla .	tyyppi
se toinen naapuri ni [MASK] mä en vielä tunne	sitä
Jos unohdan näyttää Apteekkikorttini reseptejäni käsiteltäessä tai maksaessani kassalla , voiko ostamani [MASK] siirtää jälkikäteen rekisteröintitietoihin ?	tuotteet
Mentaalisten ja tunneverbien [MASK] erottaa muista täydennyksistä erityisesti tajunnallisuuteen liittyvät eli kokijan ominaisuudet .	subjektin
Ankarimpien syyssateiden sattuessa [MASK] ovat yleensä jo vierotettu .	poikaset
Quebecin kiihkeää ja tunteiden hallitsemaa [MASK] on seurattu huolestuneena muualla Kanadassa .	itsenäisyyskeskustelua
Ilman vaadittuja selvityksiä [MASK] ei ole voitu vertailla .	tarjouksia
Koiviston arvion mukaan [MASK] ei Ilomantsin taistelujen jälkeen ollut enää uhkaamassa mikään sellainen vaara , jota ei oltaisi voitu välttää .	Suomea
Ja tota nyt me ollaan [MASK] kateltu et se tulee luultavasti täyteen ,	sitä
Myös Mereltä takavarikoidut 18_000 [MASK] tuomittiin valtiolle .	markkaa
Niin minun kuin monen muunkin mielestä [MASK] käsiteltiin väärässä järjestyksessä .	liittymisasiat
Pankkeja koskevissa luvuissa Suomen Säästöpankin ( SSP:n ) [MASK] ovat laskettu vielä säästöpankkien kiintiöön .	luotot
Elikä milläs lailla [MASK] leikellää ?	sitä
Siis sitä Malmion [MASK] sitä ollaan etsiskelemässä .	talkkunapäätäkö
loput eli siis peräti 1500 [MASK] katsotaan oikeusasiamiehen toimesta aiheettomiksi .	kanteluista
Paperiliiton Tampereen osasto neljän jäsenten mielestä [MASK] on luotu ulkopuolisten toimesta ja osin harhaisten mielikuvien perusteella .	vastakkainasettelu
Elikkä , onks teil se [MASK] täytetty sitte jo	hakemus
Vaikka perheen äiti on sisustusarkkitehti , [MASK] ei ole tehty suunnitelman mukaan - se on vain muovautunut .	kotia
Pitäähän huutokaupassa aina [MASK] hankkia .	jotakin
Jos se on rakennevika , joksi sitä luulen , [MASK] voidaan korjata nopeasti .	asia
Sota sinällään ei [MASK] kiinnostanut , vaan sen aiheuttaman verenvuodatuksen ehkäisy ja hoito .	häntä
Olet sinä sentään [MASK] oppinut	jotakin
- Kai sitä nyt koulukaslinjasa [MASK] jokkainen tietää !	kuskin
Ansallako sinä ny [MASK] pirät ?	kortteeria
Olisi heille edes yhden [MASK] suonut .	voiton
Kyllä ne jonkin [MASK] ansaitsisivat .	näpäytyksen
Jos presidentti Kekkosen viime vuodet [MASK] opettivat , niin sen mikä on valheen voima .	jotakin
Sormusen ilmoituksen mukaan hän on [MASK] allekirjoittanut .	ne
Hän on jo yhden [MASK] heittänyt .	lenkin
Powellin vastine Venäjällä , kenraali Alexander Lebed , on oman [MASK] tehnyt .	ratkaisunsa
Firmat ovat nyt [MASK] saneeranneet	saneerauksensa
Ensi vuoden syyskuussa vanhin [MASK] uusitaan osittain .	kone
Kyllä Jumala sille [MASK] kasvattaa , joka raapia tahtoo .	kynnet
Miten pakolaisten ja suomalaisten [MASK] saadaan kohtaamaan toisensa ?	kulttuurit
Jos sellaisia löytyy , on molempia osapuolia tyydyttävä yhteistyön [MASK] löydettävä .	muoto
Em mä niinku mitenkään tieten tahtoe oo , mum [MASK] karsinu pois	murrettani
Kahden viikon kuluttua [MASK] siirretään ottovanhempiensa luokse .	lapsi
Rauhallinen , puolueeton [MASK] on vedetty mukaan sotaan vastoin tahtoaan .	maa
Toisilleen he eivät [MASK] kertoneet .	asiaa
Mä en oo yhtään [MASK] kohdannut joka olis tienny et mä haluun isona semmoseks ja semmoseks .	sellasta
Häävieraiden joukossa innolla [MASK] heitti myös Mikko Kuustonen .	riisiä
Vanhojen merkkien mukaan [MASK] ennakoi , jos pääskyt lentävät matalalla , tai kissat ja koirat syövät ruohoa , tai aamulla ei ole kastetta maassa .	sadetta
Lontoon Heathrow'n ja Gatwickin [MASK] Englannissa suljettiin myöhään sunnuntai-iltana pommiuhkausten vuoksi ja kaikki lennot Lontoon pääkentille keskeytettiin toistaiseksi	lentokentät
Pian me ollaan [MASK] siivottu .	tämä
Tehtävän ratkaisuksi kirjoitettujen luokkien lisäksi myös itse [MASK] pitää kääntää , ennen kuin se on ajettavissa .	testiohjelma
Nenä ja paikallislehti [MASK] kertovat : Valkeakoski on muka ollut suoranainen hajuhelvetti elokuussa .	sen
Kyllä hän olisi [MASK] tehnyt , jos olisi käsketty .	sen
En minä mitään [MASK] tähän epäkohtaan saanut mutta eivätpä saaneet muutkaan .	muutosta
Luullakseni ainakin minun lähettämäni [MASK] luettiin vankilassa , mutta käsittääksemme mitään viestejämme ei sensuroitu .	kirjeet
Tämä liitukauden lopun strutsimainen [MASK] tunnetaan nimellä Gallimimus .	dinosaurus
Totta kai minä [MASK] tunsin , tiesin varsin hyvin kuka hän oli .	hänet
Jos joku sanoo jotain merkittävää , uutta , erikoista tai joukosta poikkeavaa , [MASK] kyllä huomioidaan .	hänet
- Vittu ne [MASK] saa kiinni .	mitään
Kuolleiden muusikoiden vanhoja [MASK] käytetään häikäilemättä uusien levyjen vauhdittajina .	nauhoja
Jos vaikka pikku tippa [MASK] , hän ehdottaa .	sherryä
No jos vaikka [MASK] verran , myönnyn .	sen
Jos tämä ei riitä , [MASK] me sitten tehdään ?	mitä
Miksikähän tämän ohjelman [MASK] lopetettiin ?	lähetys
Mitä varte siun täytyy [MASK] kannattaa tommosissa .	periaatteita
Mitä sinä siitä [MASK] syytät ?	minua
Mikä siis on [MASK] haaskausta ?	ajan
Ett enkö minä [MASK] tiedä !	sitä
Mistä helvetistä hän [MASK] arvasi ?	sen
Kyllä silloin olisi mies [MASK] saanut !	kyytinsä
Kyllä minä aina [MASK] keskustasta itselleni löydän .	yksiön
Kyllä sinä nyt [MASK] keitit .	sopan
Jos siis vierelläsi nuuhkii vankan pohjavillan omaava heiluhäntä , ei kun [MASK] keräämään ja upeita luomuksia valmistamaan .	karvaa
Jos tuloksia ei löydy , [MASK] on filtteröity Twitterin toimesta .	sinut
Ja täällä nyt ei millään suurella kauppavalikoimalla [MASK] hemmotella .	asukkaita
Muutamia vuosia sitten eurooppalaisia [MASK] laajennettiin poliittisista syistä .	kiintiöitä
Maatalouteen liittyvän toimenpiteen yhteydessä on terveyden [MASK] asetettava etusijalle .	suojelu
Ja kyllä me [MASK] pistelemmekin .	niitä
5. Tämän artiklan soveltamista koskevat mahdolliset yksityiskohtaiset [MASK] voidaan antaa 7 artiklassa säädetyn menettelyn mukaisesti .	säännöt
Tilaisuuden järjestäneen Turun yliopiston fonetiikan laitoksen ajankohtaista [MASK] oli esittelemässä dosentti Maija S. Peltola .	tutkimusta
Vuoden 1998 jalkapallon [MASK] järjestettiin Ranskassa 10. kesäkuuta – 12. heinäkuuta .	maailmanmestaruuskilpailut
Toisen kierroksen puhutuin [MASK] käytiin kuitenkin Argentiinan ja Englannin välillä .	ottelu
Ennen loppuottelua suurta [MASK] herätti Brasilian tähtipelaajan Ronaldon saama mystinen sairauskohtaus .	keskustelua
Vaikka asiakas olisi epäsuora , asiakkaan [MASK] täytyy ottaa huomioon .	mielipide
Varsinkin suuremmissa yrityksissä [MASK] on jaettu tulosyksiköihin , jotka ostavat toisiltaan palveluita : esimerkiksi markkinointi ostaa IT-osastolta tietokoneet ja verkkoyhteydet .	yritys
Puolan kansantasavallassa ei [MASK] valtiollistettu , vaan se jäi pientilamuotoiseksi ja yksityiseen omistukseen .	maataloutta
Kolmanneksi jonkin maatalousalan , niin kuin tupakka-alan , [MASK] ei voi tehdä ihan nopeasti , se on hyvin vaikeata , ja sen vuoksi on epärealistista ajatella , että vähennetyt avustukset voisivat mahdollistaa nopeutuksen tässä uudelleenjärjestelyssä .	uudelleenjärjestelyä
– Olen minä [MASK] maistanut , ei tarvi nyt .	puuroa
eläinten terveyttä ja eläinlääkärintodistuksia koskevia [MASK] on mukautettava ottaen huomioon kolmannen maan terveystilanne ; tässä tapauksessa tämä koskee ainoastaan rekisteröityjä hevosia ,	vaatimuksia
Tanskassa ja Norjassa [MASK] on tuettu poistamalla niiltä autovero kokonaan .	täyssähköautoja
Varsinais-Suomen toisen asteen ammatillisen koulutuksen ja sen järjestäjäverkon toimivuutta ja kehittämistarpeita koskeva [MASK] julkistettiin Educariumissa perjantaina 5.3 .	arviointiraportti
Ensimmäinen kaupallinen Real3D [MASK] julkaistiin Amigalle vielä samana vuonna .	versio
Samalla siitokseen jäävät [MASK] luetaan lukulistoihin .	eloporot
Samalla tuntemattomiksi jääneet [MASK] ja porot voitiin panna myyntiin ja toisten paliskuntien porot saatiin erilleen omista .	vasat
Suomen europarlamenttivaaleissa 2009 vaalivoittajina [MASK] edellisvaaleihin 2004 verrattuna saivat perussuomalaiset , vihreät ja kristilliset .	lisäpaikan
Sosiaalityön ja sosiaalialan työn [MASK] ja roolia uudistuksessa ei voi olla korostamatta liikaa .	tärkeyttä
Ja oikeasti kun laseissani on prismaa , niin en voi [MASK] saada !	piilareita
Aika perustellun oloista [MASK] " paras on paras " laittanut .	tekstiä
Mutta ne eivät [MASK] tehneet .	sitä
Softan ja raudan arkkitehtuurin [MASK] näkee käyttäjä helpoiten päivittäisessä käytössä .	toiminnallisuuden
Näin oli uusi [MASK] solmittu ja Esko sai mitä pystyvimmän turvamiehen toverikseen .	ystävyysliitto
On niitä tekemättömiä [MASK] kuultu Pekkarisen tupeen alta ennenkin .	sanoja
Vain tyttöjen vanhempien jonkinlainen tolkku [MASK] esti .	sitä
... ei suuret sanat [MASK] halkaise .	suuta
Näin ollen hänen [MASK] otettiin hyvinkin tosissaan .	viestinsä
Joulumaahan matkamies jo moni [MASK] kysyy , sinne saattaa löytää , vaikka paikallansa pysyy .	tietä
Kapteeni Amerikan toinen oma [MASK] julkaistiin ainakin Pohjoismaissa ja Saksassa eri nimellä kuin Amerikassa .	elokuva
Mitä eri aihealueissa ja ketjuissa tapahtuviin nettiväittelyihin ja muihin tulee , niin aikani [MASK] saatan jaksaa , mutta mikäli ei mitään uutta tai erityistä tule , niin en niitä iankaikkisesti jaksa hinkata .	niitä
Hallintaan tuota ystävällistä ja pehmeää [MASK] voi käyttää myöskin .	sokaisutapaa
Jos takin taskussa on tarkoituksella sinne laitettu pullo tai tuoppi , täytyy [MASK] ottaa vakavasti .	uhka
Kelan harkinnanvaraisen kuntoutuksena korvaamaa [MASK] sai vuonna 2009 noin 14 700 kuntoutujaa .	psykoterapiaa
” Minkäänlaista etuuskohteluun perustuvaa tai siltä vaikuttavaa [MASK] hallitukseen ei pidä antaa yksilöille tai organisaatioille siksi , että he ovat tehneet taloudellisia lahjoituksia poliitikoille tai poliittisille puolueelle ” , lukee ohjeistuksessa .	väylää
Loppujen lopuksi organisaation [MASK] mitataan harvoin sen perusteella , kuinka turvassa olemme tai kuinka montaa sääntöä seuraamme .	toimintakykyä
Sen jälkeen , kun Kristoffer Kolumbus löysi Amerikan vuonna 1492 , espanjalaista [MASK] Antillas käytettiin kuvaamaan maata . Tästä juontui useassa eurooppalaisessa kielessä käytössä oleva Karibianmeren vaihtoehtoinen nimi ” Antillien meri ” .	termiä
Thaimaalaiset hyväenteiset päivän [MASK] merkitään viikonpäivätaulukossa , jonka alla on linkki Buddhan kuviin jokaiselle viikonpäivälle .	värit
9. syyskuuta 2002 [MASK] houkuteltiin hotelliin Beverly Hillsissä sillä verukkeella , että häntä haastateltaisiin japanilaiseen lastenohjelmaan liittyen avaruuteen .	Aldrin
Huolimatta ankarista toimistaan , [MASK] pidetään hallitsijana , joka kuunteli Alankomaiden tarpeita .	Kaarlea
Palattuaan Lahoreen noin 39 hänen [MASK] julkaistiin Gazettessa marraskuun 1886 ja kesäkuun 1887 välillä .	tarinaansa
Koko sodan ajan [MASK] Harboria käytettiin usein amerikkalaisessa propagandassa .	Pearl
Alun perin Lounais-Aasiassa , todennäköisesti Papua-Uudessa-Guineassa , jalostetut [MASK] ja jauhobanaanit jalostettiin uudelleen Afrikassa mahdollisesti jopa jo 5000 vuotta sitten .	banaanit
Ennen keisari Meijia kausien [MASK] vaihdettiin useammin , ja keisareiden kuolemanjälkeiset nimet valittiin eri tavalla .	nimiä
Vuoteen 2009 mennessä The Power of Now- ja A New Earth in North America [MASK] oli myyty yhteensä kolme ja viisi miljoonaa kappaletta , siinä järjestyksessä .	-kirjoja
30. toukokuuta 1913 allekirjoitetussa Lontoon sopimuksessa merkittävä [MASK] Albanian vaatimaa aluetta jaettiin etnisistä rakenteista välittämättä Balkanin liiton kesken . Siten Albanian alue pieneni vain sen keskusalueisiin .	osa
Lucas Cranach vanhemman kaksi esillä olevaa maalausta ovat erityisen [MASK] herättäviä .	huomiota
Toisin kuin lokakuun 28. päivän kirjeen kohdalla , Comeyn [MASK] on kommentoitu tuskin lainkaan .	kirjettä
Myös vaikka suurin [MASK] työpaikalla esiin tulevista tilanteista voidaan selvittää ilman yhteenottoa .	osa
Vuonna 1992 kunnalle jätetyn entisen nukketeatterin [MASK] ottivat haltuunsa näyttelijät ja työntekijät .	pihan
Yerba Buena Garden [MASK] rakennettiin 1990-luvulla Moscone North Convention Center -keskuksen katolle .	-puutarha
Reformaation tuloksena Disibodenbergin [MASK] lakkautettiin ja se raunioitui .	luostari
Hänen hallintonsa aikana naisten [MASK] hyväksyttiin , poliittiset puolueet laillistettiin , kaikki maasta karkotetut saivat palata , ja jäljellä olleet poliittiset vangit vapautettiin .	äänioikeus
Samaan aikaan hänen [MASK] tribuunissa otti Marcus Antonius , joka piti paikkaa joulukuuhun asti .	paikkansa
Jos näin tapahtuisi , niin silloinhan ei näitä [MASK] tarvittaisi ollenkaan , eikö niin ?	uudelleenvirittelyoppaita
ei toilaan ... makeaa [MASK] nimi tarkoittaa ... .	herkkuahan
Kyseisen vaatimustenmukaisuutta arvioivien elinten [MASK] voidaan parantaa huomattavasti .	toimintaa
Mutta täysin ehdottomasti hän ei mahdollista [MASK] tyrmää .	ehdokkuuttaan
Jos kortti katoaa tai varastetaan , sen kaikki [MASK] voidaan kuolettaa heti .	toiminnot
( 5 ) Eläinten hyvinvoinnin vuoksi olisi pitkät [MASK] , myös teuraseläinten kuljetukset , rajoitettava vähimpään mahdolliseen .	eläinkuljetukset
( 21 ) Rekisteröityjä [MASK] , sellaisina kuin ne on määritelty direktiivin 90/426/ETY 2 artiklan c alakohdassa , kuljetetaan usein muihin kuin kaupallisiin tarkoituksiin , ja tällaiset kuljetukset on suoritettava yhdenmukaisesti tämän asetuksen yleisten tavoitteiden kanssa .	hevoseläimiä
( 23 ) Huomattava [MASK] eläimiä kuljetetaan hyvin pitkiä matkoja karja-aluksilla yhteisöstä ja yhteisön sisällä , ja meriteitse kuljetettava lähetys voidaan tarkastaa lähtöpaikassa .	määrä
( 25 ) Eläinten suojelusta teurastus- tai lopettamishetkellä 22 päivänä joulukuuta 1993 annettua neuvoston [MASK] 93/119/EY olisi myös muutettava niin , että se mukautetaan tämän asetuksen säännöksiin sähkösauvojen käytön osalta .	direktiiviä
( 26 ) Jäsenvaltioiden hallintoviranomaisten keskinäisestä avunannosta sekä jäsenvaltioiden ja komission yhteistyöstä eläinlääkintää ja kotieläinjalostusta koskevan lainsäädännön oikean soveltamisen varmistamiseksi 21 päivänä marraskuuta 1989 annetussa neuvoston direktiivissä 89/608/ETY säädettyjä [MASK] ja tiedotusmenettelyitä olisi sovellettava eläinten hyvinvointiin kuljetuksen aikana , jotta varmistetaan tämän asetuksen noudattaminen .	sääntöjä
2. Ainoastaan 3 ja 27 [MASK] sovelletaan :	artiklaa
( 2 ) [MASK] teki European Chemical Industry Council ( CEFIC ) perusasetuksen 4 artiklan 1 kohdan ja 5 artiklan 4 kohdan mukaisesti sellaisten yhteisön tuottajien puolesta , joiden tuotanto muodostaa 100 prosenttia piikarbidin koko tuotannosta yhteisössä .	Valituksen
( 3 ) Slovakian interventioelimen hallussa olevat [MASK] olisi sen vuoksi saatettava yhteisön viljamarkkinoille .	maissivarastot
Jos eri tarjoukset koskevat samaa erää ja niiden yhteismäärä ylittää käytettävissä olevan määrän , [MASK] voidaan vahvistaa erikseen jokaiselle erälle .	vähimmäishinta
Vaikka tukityö ja ammatillinen koulutus purevat hyvin , [MASK] saa vain harva maahanmuuttaja .	sitä
Professori Häkkisen toimittama [MASK] on äänteiden osalta uudelleen kirjoitettu ja sisältää muun muassa selityksiä sekä laajan johdantoartikkelin .	kirja
Mikael Agricolan ja suomen kielen [MASK] juhlitaan perjantaina 9.4 .	päivää
Jos synnytys ei onnistu äidin omin voimin , [MASK] avustetaan synnytysinstrumenteilla , lähinnä imukupeilla tai pihdeillä .	synnytystä
Sittemmin Saariselän alueelle perustetun UKK-kansallispuiston vuoksi [MASK] hävitettiin .	asuinkenttä
Vapaa-ajattelijain liiton kannanoton mukaan uskonrauhan rikkomista koskeva [MASK] on kumottava .	lainkohta
